source	target	prediction
zelda likes herself <eos>	like ( zelda , zelda ) <eos>	like ( zelda , zelda ) <eos>
tracy meets john <eos>	meet ( tracy , john ) <eos>	meet ( tracy , john ) <eos>
patricia meets eliza <eos>	meet ( patricia , eliza ) <eos>	meet ( patricia , eliza ) <eos>
eliza meets winnifred <eos>	meet ( eliza , winnifred ) <eos>	meet ( eliza , winnifred ) <eos>
zelda sees tracy <eos>	see ( zelda , tracy ) <eos>	see ( zelda , tracy ) <eos>
bob likes rachael <eos>	like ( bob , rachael ) <eos>	like ( bob , rachael ) <eos>
yvette likes rachael <eos>	like ( yvettte , rachael ) <eos>	like ( yvettte , rachael ) <eos>
margaret notices ursula <eos>	notice ( margaret , ursula ) <eos>	notice ( margaret , ursula ) <eos>
claire likes francis <eos>	like ( claire , francis ) <eos>	like ( claire , francis ) <eos>
claire dislikes samuel <eos>	dislike ( claire , samuel ) <eos>	dislike ( claire , samuel ) <eos>
victor throws bob <eos>	throw ( victor , bob ) <eos>	throw ( victor , bob ) <eos>
samuel likes zelda <eos>	like ( samuel , zelda ) <eos>	like ( samuel , zelda ) <eos>
winnifred throws isla <eos>	throw ( winnifred , isla ) <eos>	throw ( winnifred , isla ) <eos>
isla throws alice <eos>	throw ( isla , alice ) <eos>	throw ( isla , alice ) <eos>
margaret sees francis <eos>	see ( margaret , francis ) <eos>	see ( margaret , francis ) <eos>
samuel throws eliza <eos>	throw ( samuel , eliza ) <eos>	throw ( samuel , eliza ) <eos>
isla dislikes lewis <eos>	dislike ( isla , lewis ) <eos>	dislike ( isla , lewis ) <eos>
patricia knows grace <eos>	know ( patricia , grace ) <eos>	know ( patricia , grace ) <eos>
claire meets quinn <eos>	meet ( claire , quinn ) <eos>	meet ( claire , quinn ) <eos>
margaret likes katherine <eos>	like ( margaret , katherine ) <eos>	like ( margaret , katherine ) <eos>
isla throws yvette <eos>	throw ( isla , yvettte ) <eos>	throw ( isla , yvettte ) <eos>
grace likes katherine <eos>	like ( grace , katherine ) <eos>	like ( grace , katherine ) <eos>
francis sees daniel <eos>	see ( francis , daniel ) <eos>	see ( francis , daniel ) <eos>
patricia notices daniel <eos>	notice ( patricia , daniel ) <eos>	notice ( patricia , daniel ) <eos>
john meets oswald <eos>	meet ( john , oswald ) <eos>	meet ( john , oswald ) <eos>
claire notices rachael <eos>	notice ( claire , rachael ) <eos>	notice ( claire , rachael ) <eos>
xerxes knows yvette <eos>	know ( xerxes , yvettte ) <eos>	know ( xerxes , yvettte ) <eos>
winnifred meets bob <eos>	meet ( winnifred , bob ) <eos>	meet ( winnifred , bob ) <eos>
katherine sees xerxes <eos>	see ( katherine , xerxes ) <eos>	see ( katherine , xerxes ) <eos>
john meets quinn <eos>	meet ( john , quinn ) <eos>	meet ( john , quinn ) <eos>
yvette meets oswald <eos>	meet ( yvettte , oswald ) <eos>	meet ( yvettte , oswald ) <eos>
yvette dislikes winnifred <eos>	dislike ( yvettte , winnifred ) <eos>	dislike ( yvettte , winnifred ) <eos>
john meets daniel <eos>	meet ( john , daniel ) <eos>	meet ( john , daniel ) <eos>
oswald dislikes quinn <eos>	dislike ( oswald , quinn ) <eos>	dislike ( oswald , quinn ) <eos>
zelda sees john <eos>	see ( zelda , john ) <eos>	see ( zelda , john ) <eos>
john likes henry <eos>	like ( john , henry ) <eos>	like ( john , henry ) <eos>
zelda dislikes zelda <eos>	dislike ( zelda , zelda ) <eos>	dislike ( zelda , zelda ) <eos>
oswald knows neha <eos>	know ( oswald , neha ) <eos>	know ( oswald , neha ) <eos>
bob dislikes eliza <eos>	dislike ( bob , eliza ) <eos>	dislike ( bob , eliza ) <eos>
john knows himself <eos>	know ( john , john ) <eos>	know ( john , john ) <eos>
katherine dislikes winnifred <eos>	dislike ( katherine , winnifred ) <eos>	dislike ( katherine , winnifred ) <eos>
bob knows oswald <eos>	know ( bob , oswald ) <eos>	know ( bob , oswald ) <eos>
victor sees isla <eos>	see ( victor , isla ) <eos>	see ( victor , isla ) <eos>
oswald likes alice <eos>	like ( oswald , alice ) <eos>	like ( oswald , alice ) <eos>
eliza likes herself <eos>	like ( eliza , eliza ) <eos>	like ( eliza , eliza ) <eos>
ursula knows neha <eos>	know ( ursula , neha ) <eos>	know ( ursula , neha ) <eos>
margaret throws claire <eos>	throw ( margaret , claire ) <eos>	throw ( margaret , claire ) <eos>
victor notices yvette <eos>	notice ( victor , yvettte ) <eos>	notice ( victor , yvettte ) <eos>
xerxes notices tracy <eos>	notice ( xerxes , tracy ) <eos>	notice ( xerxes , tracy ) <eos>
oswald meets john <eos>	meet ( oswald , john ) <eos>	meet ( oswald , john ) <eos>
isla sees neha <eos>	see ( isla , neha ) <eos>	see ( isla , neha ) <eos>
lewis knows henry <eos>	know ( lewis , henry ) <eos>	know ( lewis , henry ) <eos>
neha flies <eos>	fly ( neha ) <eos>	fly ( neha ) <eos>
margaret dances <eos>	dance ( margaret ) <eos>	dance ( margaret ) <eos>
winnifred slumbers <eos>	slumber ( winnifred ) <eos>	slumber ( winnifred ) <eos>
everyone likes lewis <eos>	all x . ( person ( x ) -> like ( x , lewis ) ) <eos>	all x . ( person ( x ) -> throw ( x , lewis ) ) <eos>
every hoplite sees tracy <eos>	all x . ( hoplite ( x ) -> see ( x , tracy ) ) <eos>	all x . ( hoplite ( x ) -> notice ( x , tracy ) ) <eos>
every dog dislikes eliza <eos>	all x . ( dog ( x ) -> dislike ( x , eliza ) ) <eos>	all x . ( prion ( x ) -> notice ( x , eliza ) ) <eos>
someone throws eliza <eos>	exists x . ( person ( x ) & throw ( x , eliza ) ) <eos>	exists x . ( person ( x ) & notice ( x , eliza ) ) <eos>
every turtle knows himself <eos>	all x . ( turtle ( x ) -> know ( x , x ) ) <eos>	all x . ( turtle ( x ) -> see ( x , x ) ) <eos>
john throws winnifred <eos>	throw ( john , winnifred ) <eos>	throw ( john , winnifred ) <eos>
patricia sees lewis <eos>	see ( patricia , lewis ) <eos>	see ( patricia , lewis ) <eos>
samuel sees john <eos>	see ( samuel , john ) <eos>	see ( samuel , john ) <eos>
quinn meets francis <eos>	meet ( quinn , francis ) <eos>	meet ( quinn , francis ) <eos>
patricia throws bob <eos>	throw ( patricia , bob ) <eos>	throw ( patricia , bob ) <eos>
every bear meets margaret <eos>	all x . ( bear ( x ) -> meet ( x , margaret ) ) <eos>	all x . ( condor ( x ) -> see ( x , margaret ) ) <eos>
every hoplite sees victor <eos>	all x . ( hoplite ( x ) -> see ( x , victor ) ) <eos>	all x . ( hoplite ( x ) -> notice ( x , victor ) ) <eos>
every bear knows yvette <eos>	all x . ( bear ( x ) -> know ( x , yvettte ) ) <eos>	all x . ( condor ( x ) -> throw ( x , yvettte ) ) <eos>
every turtle meets rachael <eos>	all x . ( turtle ( x ) -> meet ( x , rachael ) ) <eos>	all x . ( turtle ( x ) -> meet ( x , rachael ) ) <eos>
someone throws henry <eos>	exists x . ( person ( x ) & throw ( x , henry ) ) <eos>	exists x . ( person ( x ) & notice ( x , henry ) ) <eos>
every turtle throws grace <eos>	all x . ( turtle ( x ) -> throw ( x , grace ) ) <eos>	all x . ( turtle ( x ) -> see ( x , grace ) ) <eos>
every dog knows claire <eos>	all x . ( dog ( x ) -> know ( x , claire ) ) <eos>	all x . ( dog ( x ) -> throw ( x , claire ) ) <eos>
every person meets lewis <eos>	all x . ( person ( x ) -> meet ( x , lewis ) ) <eos>	all x . ( person ( x ) -> throw ( x , lewis ) ) <eos>
every actor meets isla <eos>	all x . ( actor ( x ) -> meet ( x , isla ) ) <eos>	all x . ( turtle ( x ) -> meet ( x , isla ) ) <eos>
every actor dislikes eliza <eos>	all x . ( actor ( x ) -> dislike ( x , eliza ) ) <eos>	all x . ( actor ( x ) -> throw ( x , eliza ) ) <eos>
every turtle likes francis <eos>	all x . ( turtle ( x ) -> like ( x , francis ) ) <eos>	all x . ( turtle ( x ) -> meet ( x , francis ) ) <eos>
every prion notices rachael <eos>	all x . ( prion ( x ) -> notice ( x , rachael ) ) <eos>	all x . ( dog ( x ) -> meet ( x , rachael ) ) <eos>
someone notices zelda <eos>	exists x . ( person ( x ) & notice ( x , zelda ) ) <eos>	exists x . ( person ( x ) & like ( x , zelda ) ) <eos>
every person knows katherine <eos>	all x . ( person ( x ) -> know ( x , katherine ) ) <eos>	all x . ( person ( x ) -> see ( x , katherine ) ) <eos>
everyone sees grace <eos>	all x . ( person ( x ) -> see ( x , grace ) ) <eos>	all x . ( person ( x ) -> like ( x , grace ) ) <eos>
henry sees patricia <eos>	see ( henry , patricia ) <eos>	see ( henry , patricia ) <eos>
victor notices claire <eos>	notice ( victor , claire ) <eos>	notice ( victor , claire ) <eos>
lewis dislikes xerxes <eos>	dislike ( lewis , xerxes ) <eos>	dislike ( lewis , xerxes ) <eos>
lewis knows xerxes <eos>	know ( lewis , xerxes ) <eos>	know ( lewis , xerxes ) <eos>
yvette knows margaret <eos>	know ( yvettte , margaret ) <eos>	know ( yvettte , margaret ) <eos>
isla throws lewis <eos>	throw ( isla , lewis ) <eos>	throw ( isla , lewis ) <eos>
henry throws daniel <eos>	throw ( henry , daniel ) <eos>	throw ( henry , daniel ) <eos>
claire sees patricia <eos>	see ( claire , patricia ) <eos>	see ( claire , patricia ) <eos>
yvette meets lewis <eos>	meet ( yvettte , lewis ) <eos>	meet ( yvettte , lewis ) <eos>
ursula notices margaret <eos>	notice ( ursula , margaret ) <eos>	notice ( ursula , margaret ) <eos>
every condor likes claire <eos>	all x . ( condor ( x ) -> like ( x , claire ) ) <eos>	all x . ( bear ( x ) -> see ( x , claire ) ) <eos>
every bear throws rachael <eos>	all x . ( bear ( x ) -> throw ( x , rachael ) ) <eos>	all x . ( bear ( x ) -> see ( x , rachael ) ) <eos>
every bear knows francis <eos>	all x . ( bear ( x ) -> know ( x , francis ) ) <eos>	all x . ( condor ( x ) -> see ( x , francis ) ) <eos>
every condor notices daniel <eos>	all x . ( condor ( x ) -> notice ( x , daniel ) ) <eos>	all x . ( condor ( x ) -> notice ( x , daniel ) ) <eos>
every hoplite dislikes oswald <eos>	all x . ( hoplite ( x ) -> dislike ( x , oswald ) ) <eos>	all x . ( hoplite ( x ) -> see ( x , oswald ) ) <eos>
every actor throws xerxes <eos>	all x . ( actor ( x ) -> throw ( x , xerxes ) ) <eos>	all x . ( actor ( x ) -> notice ( x , xerxes ) ) <eos>
every hoplite likes grace <eos>	all x . ( hoplite ( x ) -> like ( x , grace ) ) <eos>	all x . ( hoplite ( x ) -> see ( x , grace ) ) <eos>
every prion notices neha <eos>	all x . ( prion ( x ) -> notice ( x , neha ) ) <eos>	all x . ( prion ( x ) -> throw ( x , neha ) ) <eos>
every prion likes claire <eos>	all x . ( prion ( x ) -> like ( x , claire ) ) <eos>	all x . ( prion ( x ) -> see ( x , claire ) ) <eos>
every person notices tracy <eos>	all x . ( person ( x ) -> notice ( x , tracy ) ) <eos>	all x . ( person ( x ) -> notice ( x , tracy ) ) <eos>
samuel meets samuel <eos>	meet ( samuel , samuel ) <eos>	meet ( samuel , samuel ) <eos>
isla sees tracy <eos>	see ( isla , tracy ) <eos>	see ( isla , tracy ) <eos>
samuel notices patricia <eos>	notice ( samuel , patricia ) <eos>	notice ( samuel , patricia ) <eos>
lewis throws alice <eos>	throw ( lewis , alice ) <eos>	throw ( lewis , alice ) <eos>
oswald likes henry <eos>	like ( oswald , henry ) <eos>	like ( oswald , henry ) <eos>
patricia dislikes isla <eos>	dislike ( patricia , isla ) <eos>	dislike ( patricia , isla ) <eos>
xerxes meets john <eos>	meet ( xerxes , john ) <eos>	meet ( xerxes , john ) <eos>
margaret notices quinn <eos>	notice ( margaret , quinn ) <eos>	notice ( margaret , quinn ) <eos>
xerxes knows alice <eos>	know ( xerxes , alice ) <eos>	know ( xerxes , alice ) <eos>
rachael sees quinn <eos>	see ( rachael , quinn ) <eos>	see ( rachael , quinn ) <eos>
someone likes bob <eos>	exists x . ( person ( x ) & like ( x , bob ) ) <eos>	exists x . ( person ( x ) & see ( x , bob ) ) <eos>
every person dislikes victor <eos>	all x . ( person ( x ) -> dislike ( x , victor ) ) <eos>	all x . ( person ( x ) -> notice ( x , victor ) ) <eos>
every prion likes zelda <eos>	all x . ( prion ( x ) -> like ( x , zelda ) ) <eos>	all x . ( prion ( x ) -> notice ( x , zelda ) ) <eos>
every hoplite notices bob <eos>	all x . ( hoplite ( x ) -> notice ( x , bob ) ) <eos>	all x . ( hoplite ( x ) -> see ( x , bob ) ) <eos>
every actor meets henry <eos>	all x . ( actor ( x ) -> meet ( x , henry ) ) <eos>	all x . ( turtle ( x ) -> meet ( x , henry ) ) <eos>
lewis likes bob <eos>	like ( lewis , bob ) <eos>	like ( lewis , bob ) <eos>
daniel knows ursula <eos>	know ( daniel , ursula ) <eos>	know ( daniel , ursula ) <eos>
winnifred notices quinn <eos>	notice ( winnifred , quinn ) <eos>	notice ( winnifred , quinn ) <eos>
francis likes alice <eos>	like ( francis , alice ) <eos>	like ( francis , alice ) <eos>
rachael meets margaret <eos>	meet ( rachael , margaret ) <eos>	meet ( rachael , margaret ) <eos>
every condor throws grace <eos>	all x . ( condor ( x ) -> throw ( x , grace ) ) <eos>	all x . ( bear ( x ) -> see ( x , grace ) ) <eos>
every prion dislikes rachael <eos>	all x . ( prion ( x ) -> dislike ( x , rachael ) ) <eos>	all x . ( dog ( x ) -> meet ( x , rachael ) ) <eos>
everyone meets francis <eos>	all x . ( person ( x ) -> meet ( x , francis ) ) <eos>	all x . ( person ( x ) -> like ( x , francis ) ) <eos>
every hoplite likes john <eos>	all x . ( hoplite ( x ) -> like ( x , john ) ) <eos>	all x . ( hoplite ( x ) -> meet ( x , john ) ) <eos>
every actor dislikes grace <eos>	all x . ( actor ( x ) -> dislike ( x , grace ) ) <eos>	all x . ( turtle ( x ) -> see ( x , grace ) ) <eos>
yvette likes francis <eos>	like ( yvettte , francis ) <eos>	like ( yvettte , francis ) <eos>
oswald knows yvette <eos>	know ( oswald , yvettte ) <eos>	know ( oswald , yvettte ) <eos>
bob sees yvette <eos>	see ( bob , yvettte ) <eos>	see ( bob , yvettte ) <eos>
quinn notices samuel <eos>	notice ( quinn , samuel ) <eos>	notice ( quinn , samuel ) <eos>
claire knows herself <eos>	know ( claire , claire ) <eos>	know ( claire , claire ) <eos>
bob knows zelda <eos>	know ( bob , zelda ) <eos>	know ( bob , zelda ) <eos>
eliza notices john <eos>	notice ( eliza , john ) <eos>	notice ( eliza , john ) <eos>
patricia dislikes katherine <eos>	dislike ( patricia , katherine ) <eos>	dislike ( patricia , katherine ) <eos>
samuel notices eliza <eos>	notice ( samuel , eliza ) <eos>	notice ( samuel , eliza ) <eos>
oswald dislikes victor <eos>	dislike ( oswald , victor ) <eos>	dislike ( oswald , victor ) <eos>
claire knows eliza <eos>	know ( claire , eliza ) <eos>	know ( claire , eliza ) <eos>
alice meets ursula <eos>	meet ( alice , ursula ) <eos>	meet ( alice , ursula ) <eos>
daniel dislikes samuel <eos>	dislike ( daniel , samuel ) <eos>	dislike ( daniel , samuel ) <eos>
oswald meets oswald <eos>	meet ( oswald , oswald ) <eos>	meet ( oswald , oswald ) <eos>
daniel likes bob <eos>	like ( daniel , bob ) <eos>	like ( daniel , bob ) <eos>
francis sees grace <eos>	see ( francis , grace ) <eos>	see ( francis , grace ) <eos>
bob likes isla <eos>	like ( bob , isla ) <eos>	like ( bob , isla ) <eos>
xerxes sees tracy <eos>	see ( xerxes , tracy ) <eos>	see ( xerxes , tracy ) <eos>
bob knows quinn <eos>	know ( bob , quinn ) <eos>	know ( bob , quinn ) <eos>
alice likes ursula <eos>	like ( alice , ursula ) <eos>	like ( alice , ursula ) <eos>
someone notices zelda <eos>	exists x . ( person ( x ) & notice ( x , zelda ) ) <eos>	exists x . ( person ( x ) & like ( x , zelda ) ) <eos>
every prion likes rachael <eos>	all x . ( prion ( x ) -> like ( x , rachael ) ) <eos>	all x . ( dog ( x ) -> meet ( x , rachael ) ) <eos>
someone sees yvette <eos>	exists x . ( person ( x ) & see ( x , yvettte ) ) <eos>	exists x . ( person ( x ) & see ( x , yvettte ) ) <eos>
someone sees samuel <eos>	exists x . ( person ( x ) & see ( x , samuel ) ) <eos>	exists x . ( person ( x ) & like ( x , samuel ) ) <eos>
every prion sees lewis <eos>	all x . ( prion ( x ) -> see ( x , lewis ) ) <eos>	all x . ( prion ( x ) -> throw ( x , lewis ) ) <eos>
claire knows tracy <eos>	know ( claire , tracy ) <eos>	know ( claire , tracy ) <eos>
henry dislikes henry <eos>	dislike ( henry , henry ) <eos>	dislike ( henry , henry ) <eos>
katherine sees tracy <eos>	see ( katherine , tracy ) <eos>	see ( katherine , tracy ) <eos>
margaret throws winnifred <eos>	throw ( margaret , winnifred ) <eos>	throw ( margaret , winnifred ) <eos>
xerxes notices daniel <eos>	notice ( xerxes , daniel ) <eos>	notice ( xerxes , daniel ) <eos>
tracy sees lewis <eos>	see ( tracy , lewis ) <eos>	see ( tracy , lewis ) <eos>
neha sees zelda <eos>	see ( neha , zelda ) <eos>	see ( neha , zelda ) <eos>
grace knows yvette <eos>	know ( grace , yvettte ) <eos>	know ( grace , yvettte ) <eos>
daniel sees bob <eos>	see ( daniel , bob ) <eos>	see ( daniel , bob ) <eos>
xerxes likes bob <eos>	like ( xerxes , bob ) <eos>	like ( xerxes , bob ) <eos>
rachael notices rachael <eos>	notice ( rachael , rachael ) <eos>	notice ( rachael , rachael ) <eos>
samuel meets himself <eos>	meet ( samuel , samuel ) <eos>	meet ( samuel , samuel ) <eos>
francis dislikes rachael <eos>	dislike ( francis , rachael ) <eos>	dislike ( francis , rachael ) <eos>
eliza dislikes ursula <eos>	dislike ( eliza , ursula ) <eos>	dislike ( eliza , ursula ) <eos>
oswald notices lewis <eos>	notice ( oswald , lewis ) <eos>	notice ( oswald , lewis ) <eos>
every condor dislikes margaret <eos>	all x . ( condor ( x ) -> dislike ( x , margaret ) ) <eos>	all x . ( condor ( x ) -> see ( x , margaret ) ) <eos>
every turtle knows eliza <eos>	all x . ( turtle ( x ) -> know ( x , eliza ) ) <eos>	all x . ( turtle ( x ) -> throw ( x , eliza ) ) <eos>
someone knows bob <eos>	exists x . ( person ( x ) & know ( x , bob ) ) <eos>	exists x . ( person ( x ) & know ( x , bob ) ) <eos>
every prion dislikes winnifred <eos>	all x . ( prion ( x ) -> dislike ( x , winnifred ) ) <eos>	all x . ( prion ( x ) -> see ( x , winnifred ) ) <eos>
everyone notices neha <eos>	all x . ( person ( x ) -> notice ( x , neha ) ) <eos>	all x . ( person ( x ) -> throw ( x , neha ) ) <eos>
bob meets grace <eos>	meet ( bob , grace ) <eos>	meet ( bob , grace ) <eos>
henry likes tracy <eos>	like ( henry , tracy ) <eos>	like ( henry , tracy ) <eos>
daniel notices samuel <eos>	notice ( daniel , samuel ) <eos>	notice ( daniel , samuel ) <eos>
xerxes dislikes eliza <eos>	dislike ( xerxes , eliza ) <eos>	dislike ( xerxes , eliza ) <eos>
patricia dislikes patricia <eos>	dislike ( patricia , patricia ) <eos>	dislike ( patricia , patricia ) <eos>
oswald sees isla <eos>	see ( oswald , isla ) <eos>	see ( oswald , isla ) <eos>
eliza dislikes margaret <eos>	dislike ( eliza , margaret ) <eos>	dislike ( eliza , margaret ) <eos>
lewis notices margaret <eos>	notice ( lewis , margaret ) <eos>	notice ( lewis , margaret ) <eos>
patricia knows daniel <eos>	know ( patricia , daniel ) <eos>	know ( patricia , daniel ) <eos>
rachael throws bob <eos>	throw ( rachael , bob ) <eos>	throw ( rachael , bob ) <eos>
bob notices isla <eos>	notice ( bob , isla ) <eos>	notice ( bob , isla ) <eos>
katherine knows winnifred <eos>	know ( katherine , winnifred ) <eos>	know ( katherine , winnifred ) <eos>
henry meets grace <eos>	meet ( henry , grace ) <eos>	meet ( henry , grace ) <eos>
yvette likes alice <eos>	like ( yvettte , alice ) <eos>	like ( yvettte , alice ) <eos>
quinn meets claire <eos>	meet ( quinn , claire ) <eos>	meet ( quinn , claire ) <eos>
isla dislikes samuel <eos>	dislike ( isla , samuel ) <eos>	dislike ( isla , samuel ) <eos>
xerxes knows victor <eos>	know ( xerxes , victor ) <eos>	know ( xerxes , victor ) <eos>
claire meets john <eos>	meet ( claire , john ) <eos>	meet ( claire , john ) <eos>
rachael dislikes isla <eos>	dislike ( rachael , isla ) <eos>	dislike ( rachael , isla ) <eos>
tracy dislikes winnifred <eos>	dislike ( tracy , winnifred ) <eos>	dislike ( tracy , winnifred ) <eos>
quinn knows alice <eos>	know ( quinn , alice ) <eos>	know ( quinn , alice ) <eos>
neha knows xerxes <eos>	know ( neha , xerxes ) <eos>	know ( neha , xerxes ) <eos>
neha dislikes tracy <eos>	dislike ( neha , tracy ) <eos>	dislike ( neha , tracy ) <eos>
john likes victor <eos>	like ( john , victor ) <eos>	like ( john , victor ) <eos>
katherine meets isla <eos>	meet ( katherine , isla ) <eos>	meet ( katherine , isla ) <eos>
rachael throws daniel <eos>	throw ( rachael , daniel ) <eos>	throw ( rachael , daniel ) <eos>
margaret notices john <eos>	notice ( margaret , john ) <eos>	notice ( margaret , john ) <eos>
victor meets henry <eos>	meet ( victor , henry ) <eos>	meet ( victor , henry ) <eos>
samuel dislikes victor <eos>	dislike ( samuel , victor ) <eos>	dislike ( samuel , victor ) <eos>
john notices yvette <eos>	notice ( john , yvettte ) <eos>	notice ( john , yvettte ) <eos>
patricia throws patricia <eos>	throw ( patricia , patricia ) <eos>	throw ( patricia , patricia ) <eos>
yvette notices john <eos>	notice ( yvettte , john ) <eos>	notice ( yvettte , john ) <eos>
katherine throws rachael <eos>	throw ( katherine , rachael ) <eos>	throw ( katherine , rachael ) <eos>
bob sees isla <eos>	see ( bob , isla ) <eos>	see ( bob , isla ) <eos>
margaret likes lewis <eos>	like ( margaret , lewis ) <eos>	like ( margaret , lewis ) <eos>
alice notices grace <eos>	notice ( alice , grace ) <eos>	notice ( alice , grace ) <eos>
zelda throws zelda <eos>	throw ( zelda , zelda ) <eos>	throw ( zelda , zelda ) <eos>
zelda meets katherine <eos>	meet ( zelda , katherine ) <eos>	meet ( zelda , katherine ) <eos>
francis meets xerxes <eos>	meet ( francis , xerxes ) <eos>	meet ( francis , xerxes ) <eos>
lewis notices samuel <eos>	notice ( lewis , samuel ) <eos>	notice ( lewis , samuel ) <eos>
someone knows henry <eos>	exists x . ( person ( x ) & know ( x , henry ) ) <eos>	exists x . ( person ( x ) & know ( x , henry ) ) <eos>
every prion notices patricia <eos>	all x . ( prion ( x ) -> notice ( x , patricia ) ) <eos>	all x . ( prion ( x ) -> throw ( x , patricia ) ) <eos>
every actor sees winnifred <eos>	all x . ( actor ( x ) -> see ( x , winnifred ) ) <eos>	all x . ( turtle ( x ) -> see ( x , winnifred ) ) <eos>
every person notices eliza <eos>	all x . ( person ( x ) -> notice ( x , eliza ) ) <eos>	all x . ( person ( x ) -> notice ( x , eliza ) ) <eos>
someone sees winnifred <eos>	exists x . ( person ( x ) & see ( x , winnifred ) ) <eos>	exists x . ( person ( x ) & like ( x , winnifred ) ) <eos>
katherine throws francis <eos>	throw ( katherine , francis ) <eos>	throw ( katherine , francis ) <eos>
bob likes victor <eos>	like ( bob , victor ) <eos>	like ( bob , victor ) <eos>
daniel throws rachael <eos>	throw ( daniel , rachael ) <eos>	throw ( daniel , rachael ) <eos>
winnifred notices winnifred <eos>	notice ( winnifred , winnifred ) <eos>	notice ( winnifred , winnifred ) <eos>
patricia throws samuel <eos>	throw ( patricia , samuel ) <eos>	throw ( patricia , samuel ) <eos>
xerxes knows zelda <eos>	know ( xerxes , zelda ) <eos>	know ( xerxes , zelda ) <eos>
tracy likes rachael <eos>	like ( tracy , rachael ) <eos>	like ( tracy , rachael ) <eos>
tracy likes eliza <eos>	like ( tracy , eliza ) <eos>	like ( tracy , eliza ) <eos>
francis sees quinn <eos>	see ( francis , quinn ) <eos>	see ( francis , quinn ) <eos>
lewis sees henry <eos>	see ( lewis , henry ) <eos>	see ( lewis , henry ) <eos>
everyone likes grace <eos>	all x . ( person ( x ) -> like ( x , grace ) ) <eos>	all x . ( person ( x ) -> like ( x , grace ) ) <eos>
every actor knows tracy <eos>	all x . ( actor ( x ) -> know ( x , tracy ) ) <eos>	all x . ( actor ( x ) -> notice ( x , tracy ) ) <eos>
every condor likes ursula <eos>	all x . ( condor ( x ) -> like ( x , ursula ) ) <eos>	all x . ( bear ( x ) -> see ( x , ursula ) ) <eos>
every dog meets neha <eos>	all x . ( dog ( x ) -> meet ( x , neha ) ) <eos>	all x . ( dog ( x ) -> throw ( x , neha ) ) <eos>
every actor notices eliza <eos>	all x . ( actor ( x ) -> notice ( x , eliza ) ) <eos>	all x . ( actor ( x ) -> notice ( x , eliza ) ) <eos>
yvette likes katherine <eos>	like ( yvettte , katherine ) <eos>	like ( yvettte , katherine ) <eos>
zelda knows francis <eos>	know ( zelda , francis ) <eos>	know ( zelda , francis ) <eos>
xerxes likes rachael <eos>	like ( xerxes , rachael ) <eos>	like ( xerxes , rachael ) <eos>
henry notices samuel <eos>	notice ( henry , samuel ) <eos>	notice ( henry , samuel ) <eos>
victor meets eliza <eos>	meet ( victor , eliza ) <eos>	meet ( victor , eliza ) <eos>
henry dislikes quinn <eos>	dislike ( henry , quinn ) <eos>	dislike ( henry , quinn ) <eos>
neha likes alice <eos>	like ( neha , alice ) <eos>	like ( neha , alice ) <eos>
ursula throws eliza <eos>	throw ( ursula , eliza ) <eos>	throw ( ursula , eliza ) <eos>
rachael notices bob <eos>	notice ( rachael , bob ) <eos>	notice ( rachael , bob ) <eos>
patricia meets francis <eos>	meet ( patricia , francis ) <eos>	meet ( patricia , francis ) <eos>
john meets samuel <eos>	meet ( john , samuel ) <eos>	meet ( john , samuel ) <eos>
katherine dislikes john <eos>	dislike ( katherine , john ) <eos>	dislike ( katherine , john ) <eos>
neha knows katherine <eos>	know ( neha , katherine ) <eos>	know ( neha , katherine ) <eos>
claire meets samuel <eos>	meet ( claire , samuel ) <eos>	meet ( claire , samuel ) <eos>
katherine meets victor <eos>	meet ( katherine , victor ) <eos>	meet ( katherine , victor ) <eos>
tracy sees francis <eos>	see ( tracy , francis ) <eos>	see ( tracy , francis ) <eos>
henry notices oswald <eos>	notice ( henry , oswald ) <eos>	notice ( henry , oswald ) <eos>
patricia knows ursula <eos>	know ( patricia , ursula ) <eos>	know ( patricia , ursula ) <eos>
xerxes notices tracy <eos>	notice ( xerxes , tracy ) <eos>	notice ( xerxes , tracy ) <eos>
neha dislikes katherine <eos>	dislike ( neha , katherine ) <eos>	dislike ( neha , katherine ) <eos>
samuel throws yvette <eos>	throw ( samuel , yvettte ) <eos>	throw ( samuel , yvettte ) <eos>
john meets xerxes <eos>	meet ( john , xerxes ) <eos>	meet ( john , xerxes ) <eos>
isla notices samuel <eos>	notice ( isla , samuel ) <eos>	notice ( isla , samuel ) <eos>
yvette sees winnifred <eos>	see ( yvettte , winnifred ) <eos>	see ( yvettte , winnifred ) <eos>
oswald notices francis <eos>	notice ( oswald , francis ) <eos>	notice ( oswald , francis ) <eos>
quinn sees xerxes <eos>	see ( quinn , xerxes ) <eos>	see ( quinn , xerxes ) <eos>
zelda likes claire <eos>	like ( zelda , claire ) <eos>	like ( zelda , claire ) <eos>
isla throws grace <eos>	throw ( isla , grace ) <eos>	throw ( isla , grace ) <eos>
zelda meets samuel <eos>	meet ( zelda , samuel ) <eos>	meet ( zelda , samuel ) <eos>
claire dislikes rachael <eos>	dislike ( claire , rachael ) <eos>	dislike ( claire , rachael ) <eos>
rachael meets oswald <eos>	meet ( rachael , oswald ) <eos>	meet ( rachael , oswald ) <eos>
neha dislikes grace <eos>	dislike ( neha , grace ) <eos>	dislike ( neha , grace ) <eos>
grace notices ursula <eos>	notice ( grace , ursula ) <eos>	notice ( grace , ursula ) <eos>
grace likes john <eos>	like ( grace , john ) <eos>	like ( grace , john ) <eos>
bob knows grace <eos>	know ( bob , grace ) <eos>	know ( bob , grace ) <eos>
lewis meets yvette <eos>	meet ( lewis , yvettte ) <eos>	meet ( lewis , yvettte ) <eos>
grace likes margaret <eos>	like ( grace , margaret ) <eos>	like ( grace , margaret ) <eos>
john meets xerxes <eos>	meet ( john , xerxes ) <eos>	meet ( john , xerxes ) <eos>
samuel sees ursula <eos>	see ( samuel , ursula ) <eos>	see ( samuel , ursula ) <eos>
samuel meets winnifred <eos>	meet ( samuel , winnifred ) <eos>	meet ( samuel , winnifred ) <eos>
every bear knows grace <eos>	all x . ( bear ( x ) -> know ( x , grace ) ) <eos>	all x . ( bear ( x ) -> see ( x , grace ) ) <eos>
everyone dislikes winnifred <eos>	all x . ( person ( x ) -> dislike ( x , winnifred ) ) <eos>	all x . ( person ( x ) -> like ( x , winnifred ) ) <eos>
every hoplite likes victor <eos>	all x . ( hoplite ( x ) -> like ( x , victor ) ) <eos>	all x . ( hoplite ( x ) -> notice ( x , victor ) ) <eos>
every bear likes quinn <eos>	all x . ( bear ( x ) -> like ( x , quinn ) ) <eos>	all x . ( bear ( x ) -> dislike ( x , quinn ) ) <eos>
every actor dislikes tracy <eos>	all x . ( actor ( x ) -> dislike ( x , tracy ) ) <eos>	all x . ( actor ( x ) -> notice ( x , tracy ) ) <eos>
every dog notices lewis <eos>	all x . ( dog ( x ) -> notice ( x , lewis ) ) <eos>	all x . ( prion ( x ) -> throw ( x , lewis ) ) <eos>
every prion likes ursula <eos>	all x . ( prion ( x ) -> like ( x , ursula ) ) <eos>	all x . ( dog ( x ) -> see ( x , ursula ) ) <eos>
every prion knows herself <eos>	all x . ( prion ( x ) -> know ( x , x ) ) <eos>	all x . ( dog ( x ) -> see ( x , x ) ) <eos>
every turtle likes himself <eos>	all x . ( turtle ( x ) -> like ( x , x ) ) <eos>	all x . ( turtle ( x ) -> see ( x , x ) ) <eos>
every actor throws herself <eos>	all x . ( actor ( x ) -> throw ( x , x ) ) <eos>	all x . ( actor ( x ) -> notice ( x , x ) ) <eos>
neha notices winnifred <eos>	notice ( neha , winnifred ) <eos>	notice ( neha , winnifred ) <eos>
samuel dislikes lewis <eos>	dislike ( samuel , lewis ) <eos>	dislike ( samuel , lewis ) <eos>
yvette throws bob <eos>	throw ( yvettte , bob ) <eos>	throw ( yvettte , bob ) <eos>
patricia sees xerxes <eos>	see ( patricia , xerxes ) <eos>	see ( patricia , xerxes ) <eos>
eliza notices samuel <eos>	notice ( eliza , samuel ) <eos>	notice ( eliza , samuel ) <eos>
neha dislikes margaret <eos>	dislike ( neha , margaret ) <eos>	dislike ( neha , margaret ) <eos>
samuel knows zelda <eos>	know ( samuel , zelda ) <eos>	know ( samuel , zelda ) <eos>
xerxes meets samuel <eos>	meet ( xerxes , samuel ) <eos>	meet ( xerxes , samuel ) <eos>
margaret dislikes yvette <eos>	dislike ( margaret , yvettte ) <eos>	dislike ( margaret , yvettte ) <eos>
neha likes zelda <eos>	like ( neha , zelda ) <eos>	like ( neha , zelda ) <eos>
every dog knows zelda <eos>	all x . ( dog ( x ) -> know ( x , zelda ) ) <eos>	all x . ( dog ( x ) -> notice ( x , zelda ) ) <eos>
every prion sees ursula <eos>	all x . ( prion ( x ) -> see ( x , ursula ) ) <eos>	all x . ( dog ( x ) -> see ( x , ursula ) ) <eos>
every turtle throws himself <eos>	all x . ( turtle ( x ) -> throw ( x , x ) ) <eos>	all x . ( actor ( x ) -> see ( x , claire ) ) <eos>
every bear throws samuel <eos>	all x . ( bear ( x ) -> throw ( x , samuel ) ) <eos>	all x . ( bear ( x ) -> like ( x , samuel ) ) <eos>
every hoplite throws zelda <eos>	all x . ( hoplite ( x ) -> throw ( x , zelda ) ) <eos>	all x . ( hoplite ( x ) -> notice ( x , zelda ) ) <eos>
margaret sees quinn <eos>	see ( margaret , quinn ) <eos>	see ( margaret , quinn ) <eos>
zelda throws yvette <eos>	throw ( zelda , yvettte ) <eos>	throw ( zelda , yvettte ) <eos>
bob likes alice <eos>	like ( bob , alice ) <eos>	like ( bob , alice ) <eos>
daniel throws henry <eos>	throw ( daniel , henry ) <eos>	throw ( daniel , henry ) <eos>
daniel knows winnifred <eos>	know ( daniel , winnifred ) <eos>	know ( daniel , winnifred ) <eos>
margaret sees tracy <eos>	see ( margaret , tracy ) <eos>	see ( margaret , tracy ) <eos>
eliza sees oswald <eos>	see ( eliza , oswald ) <eos>	see ( eliza , oswald ) <eos>
samuel likes margaret <eos>	like ( samuel , margaret ) <eos>	like ( samuel , margaret ) <eos>
henry throws tracy <eos>	throw ( henry , tracy ) <eos>	throw ( henry , tracy ) <eos>
lewis meets samuel <eos>	meet ( lewis , samuel ) <eos>	meet ( lewis , samuel ) <eos>
daniel throws neha <eos>	throw ( daniel , neha ) <eos>	throw ( daniel , neha ) <eos>
tracy meets isla <eos>	meet ( tracy , isla ) <eos>	meet ( tracy , isla ) <eos>
victor knows isla <eos>	know ( victor , isla ) <eos>	know ( victor , isla ) <eos>
isla meets henry <eos>	meet ( isla , henry ) <eos>	meet ( isla , henry ) <eos>
henry knows yvette <eos>	know ( henry , yvettte ) <eos>	know ( henry , yvettte ) <eos>
neha sees tracy <eos>	see ( neha , tracy ) <eos>	see ( neha , tracy ) <eos>
tracy likes zelda <eos>	like ( tracy , zelda ) <eos>	like ( tracy , zelda ) <eos>
rachael meets grace <eos>	meet ( rachael , grace ) <eos>	meet ( rachael , grace ) <eos>
henry notices daniel <eos>	notice ( henry , daniel ) <eos>	notice ( henry , daniel ) <eos>
claire dislikes margaret <eos>	dislike ( claire , margaret ) <eos>	dislike ( claire , margaret ) <eos>
every actor notices lewis <eos>	all x . ( actor ( x ) -> notice ( x , lewis ) ) <eos>	all x . ( actor ( x ) -> throw ( x , lewis ) ) <eos>
every turtle likes isla <eos>	all x . ( turtle ( x ) -> like ( x , isla ) ) <eos>	all x . ( turtle ( x ) -> throw ( x , isla ) ) <eos>
every prion throws rachael <eos>	all x . ( prion ( x ) -> throw ( x , rachael ) ) <eos>	all x . ( dog ( x ) -> meet ( x , rachael ) ) <eos>
every turtle dislikes victor <eos>	all x . ( turtle ( x ) -> dislike ( x , victor ) ) <eos>	all x . ( turtle ( x ) -> notice ( x , victor ) ) <eos>
every bear throws henry <eos>	all x . ( bear ( x ) -> throw ( x , henry ) ) <eos>	all x . ( condor ( x ) -> notice ( x , henry ) ) <eos>
every condor knows neha <eos>	all x . ( condor ( x ) -> know ( x , neha ) ) <eos>	all x . ( bear ( x ) -> throw ( x , neha ) ) <eos>
every turtle knows zelda <eos>	all x . ( turtle ( x ) -> know ( x , zelda ) ) <eos>	all x . ( turtle ( x ) -> notice ( x , zelda ) ) <eos>
every prion likes rachael <eos>	all x . ( prion ( x ) -> like ( x , rachael ) ) <eos>	all x . ( dog ( x ) -> meet ( x , rachael ) ) <eos>
every person throws henry <eos>	all x . ( person ( x ) -> throw ( x , henry ) ) <eos>	all x . ( person ( x ) -> notice ( x , henry ) ) <eos>
every hoplite meets xerxes <eos>	all x . ( hoplite ( x ) -> meet ( x , xerxes ) ) <eos>	all x . ( hoplite ( x ) -> notice ( x , xerxes ) ) <eos>
xerxes walks <eos>	walk ( xerxes ) <eos>	walk ( xerxes ) <eos>
samuel flies <eos>	fly ( samuel ) <eos>	fly ( samuel ) <eos>
lewis sings <eos>	sing ( lewis ) <eos>	sing ( lewis ) <eos>
samuel sleeps <eos>	sleep ( samuel ) <eos>	sleep ( samuel ) <eos>
margaret slumbers <eos>	slumber ( margaret ) <eos>	slumber ( margaret ) <eos>
every actor sees john <eos>	all x . ( actor ( x ) -> see ( x , john ) ) <eos>	all x . ( turtle ( x ) -> meet ( x , john ) ) <eos>
every prion throws victor <eos>	all x . ( prion ( x ) -> throw ( x , victor ) ) <eos>	all x . ( prion ( x ) -> notice ( x , victor ) ) <eos>
everyone sees himself <eos>	all x . ( person ( x ) -> see ( x , x ) ) <eos>	all x . ( person ( x ) -> see ( x , x ) ) <eos>
every actor sees isla <eos>	all x . ( actor ( x ) -> see ( x , isla ) ) <eos>	all x . ( actor ( x ) -> meet ( x , isla ) ) <eos>
every bear dislikes margaret <eos>	all x . ( bear ( x ) -> dislike ( x , margaret ) ) <eos>	all x . ( condor ( x ) -> see ( x , margaret ) ) <eos>
someone notices alice <eos>	exists x . ( person ( x ) & notice ( x , alice ) ) <eos>	exists x . ( person ( x ) & like ( x , alice ) ) <eos>
someone sees neha <eos>	exists x . ( person ( x ) & see ( x , neha ) ) <eos>	exists x . ( person ( x ) & see ( x , neha ) ) <eos>
every prion throws tracy <eos>	all x . ( prion ( x ) -> throw ( x , tracy ) ) <eos>	all x . ( prion ( x ) -> notice ( x , tracy ) ) <eos>
every prion meets john <eos>	all x . ( prion ( x ) -> meet ( x , john ) ) <eos>	all x . ( prion ( x ) -> see ( x , john ) ) <eos>
every prion knows winnifred <eos>	all x . ( prion ( x ) -> know ( x , winnifred ) ) <eos>	all x . ( prion ( x ) -> see ( x , winnifred ) ) <eos>
rachael meets zelda <eos>	meet ( rachael , zelda ) <eos>	meet ( rachael , zelda ) <eos>
patricia meets tracy <eos>	meet ( patricia , tracy ) <eos>	meet ( patricia , tracy ) <eos>
lewis meets xerxes <eos>	meet ( lewis , xerxes ) <eos>	meet ( lewis , xerxes ) <eos>
daniel throws ursula <eos>	throw ( daniel , ursula ) <eos>	throw ( daniel , ursula ) <eos>
eliza meets alice <eos>	meet ( eliza , alice ) <eos>	meet ( eliza , alice ) <eos>
every hoplite likes katherine <eos>	all x . ( hoplite ( x ) -> like ( x , katherine ) ) <eos>	all x . ( hoplite ( x ) -> see ( x , katherine ) ) <eos>
every turtle likes herself <eos>	all x . ( turtle ( x ) -> like ( x , x ) ) <eos>	all x . ( actor ( x ) -> see ( x , claire ) ) <eos>
every prion likes samuel <eos>	all x . ( prion ( x ) -> like ( x , samuel ) ) <eos>	all x . ( prion ( x ) -> see ( x , samuel ) ) <eos>
every dog knows francis <eos>	all x . ( dog ( x ) -> know ( x , francis ) ) <eos>	all x . ( dog ( x ) -> meet ( x , francis ) ) <eos>
someone throws ursula <eos>	exists x . ( person ( x ) & throw ( x , ursula ) ) <eos>	exists x . ( person ( x ) & meet ( x , ursula ) ) <eos>
margaret knows francis <eos>	know ( margaret , francis ) <eos>	know ( margaret , francis ) <eos>
neha knows eliza <eos>	know ( neha , eliza ) <eos>	know ( neha , eliza ) <eos>
henry sees xerxes <eos>	see ( henry , xerxes ) <eos>	see ( henry , xerxes ) <eos>
victor knows daniel <eos>	know ( victor , daniel ) <eos>	know ( victor , daniel ) <eos>
grace throws quinn <eos>	throw ( grace , quinn ) <eos>	throw ( grace , quinn ) <eos>
claire throws zelda <eos>	throw ( claire , zelda ) <eos>	throw ( claire , zelda ) <eos>
xerxes meets patricia <eos>	meet ( xerxes , patricia ) <eos>	meet ( xerxes , patricia ) <eos>
yvette notices katherine <eos>	notice ( yvettte , katherine ) <eos>	notice ( yvettte , katherine ) <eos>
yvette sees margaret <eos>	see ( yvettte , margaret ) <eos>	see ( yvettte , margaret ) <eos>
victor notices margaret <eos>	notice ( victor , margaret ) <eos>	notice ( victor , margaret ) <eos>
isla sees katherine <eos>	see ( isla , katherine ) <eos>	see ( isla , katherine ) <eos>
yvette notices yvette <eos>	notice ( yvettte , yvettte ) <eos>	notice ( yvettte , yvettte ) <eos>
daniel likes zelda <eos>	like ( daniel , zelda ) <eos>	like ( daniel , zelda ) <eos>
oswald knows ursula <eos>	know ( oswald , ursula ) <eos>	know ( oswald , ursula ) <eos>
henry throws john <eos>	throw ( henry , john ) <eos>	throw ( henry , john ) <eos>
someone dislikes samuel <eos>	exists x . ( person ( x ) & dislike ( x , samuel ) ) <eos>	exists x . ( person ( x ) & like ( x , samuel ) ) <eos>
every dog dislikes john <eos>	all x . ( dog ( x ) -> dislike ( x , john ) ) <eos>	all x . ( dog ( x ) -> see ( x , john ) ) <eos>
everyone likes ursula <eos>	all x . ( person ( x ) -> like ( x , ursula ) ) <eos>	all x . ( person ( x ) -> dislike ( x , ursula ) ) <eos>
every turtle knows alice <eos>	all x . ( turtle ( x ) -> know ( x , alice ) ) <eos>	all x . ( turtle ( x ) -> meet ( x , alice ) ) <eos>
every turtle meets xerxes <eos>	all x . ( turtle ( x ) -> meet ( x , xerxes ) ) <eos>	all x . ( turtle ( x ) -> notice ( x , xerxes ) ) <eos>
every turtle knows zelda <eos>	all x . ( turtle ( x ) -> know ( x , zelda ) ) <eos>	all x . ( turtle ( x ) -> notice ( x , zelda ) ) <eos>
every dog meets rachael <eos>	all x . ( dog ( x ) -> meet ( x , rachael ) ) <eos>	all x . ( dog ( x ) -> meet ( x , rachael ) ) <eos>
every hoplite notices bob <eos>	all x . ( hoplite ( x ) -> notice ( x , bob ) ) <eos>	all x . ( hoplite ( x ) -> see ( x , bob ) ) <eos>
everyone meets ursula <eos>	all x . ( person ( x ) -> meet ( x , ursula ) ) <eos>	all x . ( person ( x ) -> see ( x , ursula ) ) <eos>
every bear throws katherine <eos>	all x . ( bear ( x ) -> throw ( x , katherine ) ) <eos>	all x . ( bear ( x ) -> meet ( x , katherine ) ) <eos>
every turtle sees tracy <eos>	all x . ( turtle ( x ) -> see ( x , tracy ) ) <eos>	all x . ( turtle ( x ) -> notice ( x , tracy ) ) <eos>
every turtle dances <eos>	all x . ( turtle ( x ) -> dance ( x ) ) <eos>	all x . ( person ( x ) -> see ( x ) ) <eos>
oswald throws isla <eos>	throw ( oswald , isla ) <eos>	notice ( daniel , isla ) <eos>
francis dislikes eliza <eos>	dislike ( francis , eliza ) <eos>	exists ( patricia , lewis ) <eos>
claire dislikes john <eos>	dislike ( claire , john ) <eos>	sing ( yvettte , margaret ) <eos>
every person sees margaret <eos>	all x . ( person ( x ) -> see ( x , margaret ) ) <eos>	all x . ( person ( x ) -> see ( x , margaret ) ) <eos>
every turtle meets herself <eos>	all x . ( turtle ( x ) -> meet ( x , x ) ) <eos>	all x . ( turtle ( x ) -> notice ( x , x ) ) <eos>
someone meets grace <eos>	exists x . ( person ( x ) & meet ( x , grace ) ) <eos>	exists x . ( person ( x ) & like ( x , grace ) ) <eos>
every actor meets henry <eos>	all x . ( actor ( x ) -> meet ( x , henry ) ) <eos>	all x . ( turtle ( x ) -> meet ( x , henry ) ) <eos>
every condor sees xerxes <eos>	all x . ( condor ( x ) -> see ( x , xerxes ) ) <eos>	all x . ( bear ( x ) -> notice ( x , xerxes ) ) <eos>
ursula throws oswald <eos>	throw ( ursula , oswald ) <eos>	throw ( ursula , oswald ) <eos>
zelda sees katherine <eos>	see ( zelda , katherine ) <eos>	see ( zelda , katherine ) <eos>
lewis dislikes ursula <eos>	dislike ( lewis , ursula ) <eos>	dislike ( lewis , ursula ) <eos>
henry sees yvette <eos>	see ( henry , yvettte ) <eos>	see ( henry , yvettte ) <eos>
francis knows zelda <eos>	know ( francis , zelda ) <eos>	know ( francis , zelda ) <eos>
victor dislikes yvette <eos>	dislike ( victor , yvettte ) <eos>	dislike ( victor , yvettte ) <eos>
margaret notices quinn <eos>	notice ( margaret , quinn ) <eos>	notice ( margaret , quinn ) <eos>
john meets henry <eos>	meet ( john , henry ) <eos>	meet ( john , henry ) <eos>
claire likes eliza <eos>	like ( claire , eliza ) <eos>	like ( claire , eliza ) <eos>
oswald knows zelda <eos>	know ( oswald , zelda ) <eos>	know ( oswald , zelda ) <eos>
isla likes zelda <eos>	like ( isla , zelda ) <eos>	like ( isla , zelda ) <eos>
henry sees daniel <eos>	see ( henry , daniel ) <eos>	see ( henry , daniel ) <eos>
francis notices ursula <eos>	notice ( francis , ursula ) <eos>	notice ( francis , ursula ) <eos>
samuel knows patricia <eos>	know ( samuel , patricia ) <eos>	know ( samuel , patricia ) <eos>
xerxes knows grace <eos>	know ( xerxes , grace ) <eos>	know ( xerxes , grace ) <eos>
henry dislikes katherine <eos>	dislike ( henry , katherine ) <eos>	dislike ( henry , katherine ) <eos>
katherine likes bob <eos>	like ( katherine , bob ) <eos>	like ( katherine , bob ) <eos>
oswald meets rachael <eos>	meet ( oswald , rachael ) <eos>	meet ( oswald , rachael ) <eos>
samuel throws quinn <eos>	throw ( samuel , quinn ) <eos>	throw ( samuel , quinn ) <eos>
john knows samuel <eos>	know ( john , samuel ) <eos>	know ( john , samuel ) <eos>
every bear dislikes isla <eos>	all x . ( bear ( x ) -> dislike ( x , isla ) ) <eos>	all x . ( bear ( x ) -> throw ( x , isla ) ) <eos>
every turtle throws daniel <eos>	all x . ( turtle ( x ) -> throw ( x , daniel ) ) <eos>	all x . ( turtle ( x ) -> notice ( x , daniel ) ) <eos>
every condor notices grace <eos>	all x . ( condor ( x ) -> notice ( x , grace ) ) <eos>	all x . ( bear ( x ) -> see ( x , grace ) ) <eos>
every turtle dislikes patricia <eos>	all x . ( turtle ( x ) -> dislike ( x , patricia ) ) <eos>	all x . ( turtle ( x ) -> throw ( x , patricia ) ) <eos>
every person meets victor <eos>	all x . ( person ( x ) -> meet ( x , victor ) ) <eos>	all x . ( person ( x ) -> notice ( x , victor ) ) <eos>
alice meets oswald <eos>	meet ( alice , oswald ) <eos>	meet ( alice , oswald ) <eos>
isla meets winnifred <eos>	meet ( isla , winnifred ) <eos>	meet ( isla , winnifred ) <eos>
claire dislikes grace <eos>	dislike ( claire , grace ) <eos>	dislike ( claire , grace ) <eos>
patricia knows isla <eos>	know ( patricia , isla ) <eos>	know ( patricia , isla ) <eos>
patricia sees samuel <eos>	see ( patricia , samuel ) <eos>	see ( patricia , samuel ) <eos>
every actor dislikes bob <eos>	all x . ( actor ( x ) -> dislike ( x , bob ) ) <eos>	all x . ( actor ( x ) -> see ( x , bob ) ) <eos>
every actor knows winnifred <eos>	all x . ( actor ( x ) -> know ( x , winnifred ) ) <eos>	all x . ( turtle ( x ) -> see ( x , winnifred ) ) <eos>
every dog likes eliza <eos>	all x . ( dog ( x ) -> like ( x , eliza ) ) <eos>	all x . ( prion ( x ) -> notice ( x , eliza ) ) <eos>
every actor dislikes rachael <eos>	all x . ( actor ( x ) -> dislike ( x , rachael ) ) <eos>	all x . ( turtle ( x ) -> meet ( x , rachael ) ) <eos>
every bear throws quinn <eos>	all x . ( bear ( x ) -> throw ( x , quinn ) ) <eos>	all x . ( bear ( x ) -> dislike ( x , quinn ) ) <eos>
henry knows alice <eos>	know ( henry , alice ) <eos>	know ( henry , alice ) <eos>
daniel knows victor <eos>	know ( daniel , victor ) <eos>	know ( daniel , victor ) <eos>
oswald knows lewis <eos>	know ( oswald , lewis ) <eos>	know ( oswald , lewis ) <eos>
samuel dislikes quinn <eos>	dislike ( samuel , quinn ) <eos>	dislike ( samuel , quinn ) <eos>
ursula sees herself <eos>	see ( ursula , ursula ) <eos>	see ( ursula , ursula ) <eos>
margaret likes samuel <eos>	like ( margaret , samuel ) <eos>	like ( margaret , samuel ) <eos>
neha dislikes xerxes <eos>	dislike ( neha , xerxes ) <eos>	dislike ( neha , xerxes ) <eos>
oswald dislikes daniel <eos>	dislike ( oswald , daniel ) <eos>	dislike ( oswald , daniel ) <eos>
claire throws francis <eos>	throw ( claire , francis ) <eos>	throw ( claire , francis ) <eos>
bob sees zelda <eos>	see ( bob , zelda ) <eos>	see ( bob , zelda ) <eos>
katherine knows grace <eos>	know ( katherine , grace ) <eos>	know ( katherine , grace ) <eos>
samuel sees tracy <eos>	see ( samuel , tracy ) <eos>	see ( samuel , tracy ) <eos>
rachael sees rachael <eos>	see ( rachael , rachael ) <eos>	see ( rachael , rachael ) <eos>
henry sees yvette <eos>	see ( henry , yvettte ) <eos>	see ( henry , yvettte ) <eos>
katherine throws lewis <eos>	throw ( katherine , lewis ) <eos>	throw ( katherine , lewis ) <eos>
every dog sees isla <eos>	all x . ( dog ( x ) -> see ( x , isla ) ) <eos>	all x . ( prion ( x ) -> meet ( x , isla ) ) <eos>
everyone meets henry <eos>	all x . ( person ( x ) -> meet ( x , henry ) ) <eos>	all x . ( person ( x ) -> notice ( x , henry ) ) <eos>
every person throws eliza <eos>	all x . ( person ( x ) -> throw ( x , eliza ) ) <eos>	all x . ( person ( x ) -> notice ( x , eliza ) ) <eos>
every prion dislikes katherine <eos>	all x . ( prion ( x ) -> dislike ( x , katherine ) ) <eos>	all x . ( prion ( x ) -> meet ( x , katherine ) ) <eos>
every bear dislikes grace <eos>	all x . ( bear ( x ) -> dislike ( x , grace ) ) <eos>	all x . ( bear ( x ) -> see ( x , grace ) ) <eos>
every dog notices daniel <eos>	all x . ( dog ( x ) -> notice ( x , daniel ) ) <eos>	all x . ( dog ( x ) -> notice ( x , daniel ) ) <eos>
every dog throws himself <eos>	all x . ( dog ( x ) -> throw ( x , x ) ) <eos>	all x . ( bear ( x ) -> see ( x , x ) ) <eos>
every person dislikes john <eos>	all x . ( person ( x ) -> dislike ( x , john ) ) <eos>	all x . ( person ( x ) -> see ( x , john ) ) <eos>
everyone meets quinn <eos>	all x . ( person ( x ) -> meet ( x , quinn ) ) <eos>	all x . ( person ( x ) -> meet ( x , quinn ) ) <eos>
every person sees winnifred <eos>	all x . ( person ( x ) -> see ( x , winnifred ) ) <eos>	all x . ( person ( x ) -> see ( x , winnifred ) ) <eos>
john throws samuel <eos>	throw ( john , samuel ) <eos>	throw ( john , samuel ) <eos>
isla throws tracy <eos>	throw ( isla , tracy ) <eos>	throw ( isla , tracy ) <eos>
samuel dislikes tracy <eos>	dislike ( samuel , tracy ) <eos>	dislike ( samuel , tracy ) <eos>
margaret notices isla <eos>	notice ( margaret , isla ) <eos>	notice ( margaret , isla ) <eos>
zelda dislikes lewis <eos>	dislike ( zelda , lewis ) <eos>	dislike ( zelda , lewis ) <eos>
every dog likes alice <eos>	all x . ( dog ( x ) -> like ( x , alice ) ) <eos>	all x . ( dog ( x ) -> meet ( x , alice ) ) <eos>
someone likes winnifred <eos>	exists x . ( person ( x ) & like ( x , winnifred ) ) <eos>	exists x . ( person ( x ) & like ( x , winnifred ) ) <eos>
every condor throws herself <eos>	all x . ( condor ( x ) -> throw ( x , x ) ) <eos>	all x . ( condor ( x ) -> see ( x , x ) ) <eos>
every dog dislikes oswald <eos>	all x . ( dog ( x ) -> dislike ( x , oswald ) ) <eos>	all x . ( prion ( x ) -> see ( x , oswald ) ) <eos>
everyone knows zelda <eos>	all x . ( person ( x ) -> know ( x , zelda ) ) <eos>	all x . ( person ( x ) -> notice ( x , zelda ) ) <eos>
grace likes daniel <eos>	like ( grace , daniel ) <eos>	like ( grace , daniel ) <eos>
francis dislikes zelda <eos>	dislike ( francis , zelda ) <eos>	dislike ( francis , zelda ) <eos>
ursula knows margaret <eos>	know ( ursula , margaret ) <eos>	know ( ursula , margaret ) <eos>
katherine likes tracy <eos>	like ( katherine , tracy ) <eos>	like ( katherine , tracy ) <eos>
alice likes henry <eos>	like ( alice , henry ) <eos>	like ( alice , henry ) <eos>
xerxes knows tracy <eos>	know ( xerxes , tracy ) <eos>	know ( xerxes , tracy ) <eos>
quinn meets victor <eos>	meet ( quinn , victor ) <eos>	meet ( quinn , victor ) <eos>
grace sees margaret <eos>	see ( grace , margaret ) <eos>	see ( grace , margaret ) <eos>
grace throws alice <eos>	throw ( grace , alice ) <eos>	throw ( grace , alice ) <eos>
winnifred meets claire <eos>	meet ( winnifred , claire ) <eos>	meet ( winnifred , claire ) <eos>
francis notices daniel <eos>	notice ( francis , daniel ) <eos>	notice ( francis , daniel ) <eos>
zelda dislikes lewis <eos>	dislike ( zelda , lewis ) <eos>	dislike ( zelda , lewis ) <eos>
claire sees tracy <eos>	see ( claire , tracy ) <eos>	see ( claire , tracy ) <eos>
winnifred likes lewis <eos>	like ( winnifred , lewis ) <eos>	like ( winnifred , lewis ) <eos>
tracy dislikes alice <eos>	dislike ( tracy , alice ) <eos>	dislike ( tracy , alice ) <eos>
margaret throws rachael <eos>	throw ( margaret , rachael ) <eos>	throw ( margaret , rachael ) <eos>
alice sees francis <eos>	see ( alice , francis ) <eos>	see ( alice , francis ) <eos>
zelda sees john <eos>	see ( zelda , john ) <eos>	see ( zelda , john ) <eos>
daniel meets rachael <eos>	meet ( daniel , rachael ) <eos>	meet ( daniel , rachael ) <eos>
zelda notices francis <eos>	notice ( zelda , francis ) <eos>	notice ( zelda , francis ) <eos>
margaret knows john <eos>	know ( margaret , john ) <eos>	know ( margaret , john ) <eos>
daniel knows henry <eos>	know ( daniel , henry ) <eos>	know ( daniel , henry ) <eos>
bob knows claire <eos>	know ( bob , claire ) <eos>	know ( bob , claire ) <eos>
zelda dislikes winnifred <eos>	dislike ( zelda , winnifred ) <eos>	dislike ( zelda , winnifred ) <eos>
victor notices xerxes <eos>	notice ( victor , xerxes ) <eos>	notice ( victor , xerxes ) <eos>
rachael meets victor <eos>	meet ( rachael , victor ) <eos>	meet ( rachael , victor ) <eos>
daniel likes rachael <eos>	like ( daniel , rachael ) <eos>	like ( daniel , rachael ) <eos>
yvette dislikes daniel <eos>	dislike ( yvettte , daniel ) <eos>	dislike ( yvettte , daniel ) <eos>
katherine knows samuel <eos>	know ( katherine , samuel ) <eos>	know ( katherine , samuel ) <eos>
bob throws isla <eos>	throw ( bob , isla ) <eos>	throw ( bob , isla ) <eos>
every prion throws patricia <eos>	all x . ( prion ( x ) -> throw ( x , patricia ) ) <eos>	all x . ( prion ( x ) -> throw ( x , patricia ) ) <eos>
every person notices winnifred <eos>	all x . ( person ( x ) -> notice ( x , winnifred ) ) <eos>	all x . ( person ( x ) -> see ( x , winnifred ) ) <eos>
everyone dislikes margaret <eos>	all x . ( person ( x ) -> dislike ( x , margaret ) ) <eos>	all x . ( person ( x ) -> see ( x , margaret ) ) <eos>
every person likes daniel <eos>	all x . ( person ( x ) -> like ( x , daniel ) ) <eos>	all x . ( person ( x ) -> notice ( x , daniel ) ) <eos>
every person sees grace <eos>	all x . ( person ( x ) -> see ( x , grace ) ) <eos>	all x . ( person ( x ) -> see ( x , grace ) ) <eos>
victor likes claire <eos>	like ( victor , claire ) <eos>	like ( victor , claire ) <eos>
eliza meets bob <eos>	meet ( eliza , bob ) <eos>	meet ( eliza , bob ) <eos>
rachael meets quinn <eos>	meet ( rachael , quinn ) <eos>	meet ( rachael , quinn ) <eos>
daniel throws tracy <eos>	throw ( daniel , tracy ) <eos>	throw ( daniel , tracy ) <eos>
patricia notices isla <eos>	notice ( patricia , isla ) <eos>	notice ( patricia , isla ) <eos>
francis knows alice <eos>	know ( francis , alice ) <eos>	know ( francis , alice ) <eos>
xerxes meets henry <eos>	meet ( xerxes , henry ) <eos>	meet ( xerxes , henry ) <eos>
margaret meets xerxes <eos>	meet ( margaret , xerxes ) <eos>	meet ( margaret , xerxes ) <eos>
samuel throws daniel <eos>	throw ( samuel , daniel ) <eos>	throw ( samuel , daniel ) <eos>
claire likes neha <eos>	like ( claire , neha ) <eos>	like ( claire , neha ) <eos>
someone dances <eos>	exists x . ( person ( x ) & dance ( x ) ) <eos>	all x . ( person ( x ) & like ( x , francis ) ) <eos>
every actor dances <eos>	all x . ( actor ( x ) -> dance ( x ) ) <eos>	all x . ( turtle ( x ) -> walk ( x ) ) <eos>
zelda meets patricia <eos>	meet ( zelda , patricia ) <eos>	meet ( zelda , patricia ) <eos>
neha throws grace <eos>	throw ( neha , grace ) <eos>	throw ( neha , grace ) <eos>
daniel sees francis <eos>	see ( daniel , francis ) <eos>	see ( daniel , francis ) <eos>
every condor meets herself <eos>	all x . ( condor ( x ) -> meet ( x , x ) ) <eos>	all x . ( condor ( x ) -> see ( x , x ) ) <eos>
every dog meets john <eos>	all x . ( dog ( x ) -> meet ( x , john ) ) <eos>	all x . ( dog ( x ) -> meet ( x , john ) ) <eos>
every actor notices winnifred <eos>	all x . ( actor ( x ) -> notice ( x , winnifred ) ) <eos>	all x . ( turtle ( x ) -> see ( x , winnifred ) ) <eos>
someone sees alice <eos>	exists x . ( person ( x ) & see ( x , alice ) ) <eos>	exists x . ( person ( x ) & like ( x , alice ) ) <eos>
every condor notices ursula <eos>	all x . ( condor ( x ) -> notice ( x , ursula ) ) <eos>	all x . ( bear ( x ) -> see ( x , ursula ) ) <eos>
quinn sees margaret <eos>	see ( quinn , margaret ) <eos>	see ( quinn , margaret ) <eos>
neha knows xerxes <eos>	know ( neha , xerxes ) <eos>	know ( neha , xerxes ) <eos>
yvette likes herself <eos>	like ( yvettte , yvettte ) <eos>	like ( yvettte , yvettte ) <eos>
claire meets quinn <eos>	meet ( claire , quinn ) <eos>	meet ( claire , quinn ) <eos>
lewis throws john <eos>	throw ( lewis , john ) <eos>	throw ( lewis , john ) <eos>
every actor likes francis <eos>	all x . ( actor ( x ) -> like ( x , francis ) ) <eos>	all x . ( actor ( x ) -> meet ( x , francis ) ) <eos>
every actor throws grace <eos>	all x . ( actor ( x ) -> throw ( x , grace ) ) <eos>	all x . ( turtle ( x ) -> see ( x , grace ) ) <eos>
every hoplite dislikes zelda <eos>	all x . ( hoplite ( x ) -> dislike ( x , zelda ) ) <eos>	all x . ( hoplite ( x ) -> notice ( x , zelda ) ) <eos>
every turtle dislikes himself <eos>	all x . ( turtle ( x ) -> dislike ( x , x ) ) <eos>	all x . ( turtle ( x ) -> see ( x , claire ) ) <eos>
every person meets winnifred <eos>	all x . ( person ( x ) -> meet ( x , winnifred ) ) <eos>	all x . ( person ( x ) -> see ( x , winnifred ) ) <eos>
francis dislikes ursula <eos>	dislike ( francis , ursula ) <eos>	dislike ( francis , ursula ) <eos>
victor likes eliza <eos>	like ( victor , eliza ) <eos>	like ( victor , eliza ) <eos>
john dislikes yvette <eos>	dislike ( john , yvettte ) <eos>	dislike ( john , yvettte ) <eos>
tracy dislikes samuel <eos>	dislike ( tracy , samuel ) <eos>	dislike ( tracy , samuel ) <eos>
oswald likes oswald <eos>	like ( oswald , oswald ) <eos>	like ( oswald , oswald ) <eos>
lewis sees xerxes <eos>	see ( lewis , xerxes ) <eos>	see ( lewis , xerxes ) <eos>
bob sees quinn <eos>	see ( bob , quinn ) <eos>	see ( bob , quinn ) <eos>
rachael notices victor <eos>	notice ( rachael , victor ) <eos>	notice ( rachael , victor ) <eos>
yvette notices neha <eos>	notice ( yvettte , neha ) <eos>	notice ( yvettte , neha ) <eos>
bob dislikes grace <eos>	dislike ( bob , grace ) <eos>	dislike ( bob , grace ) <eos>
alice meets herself <eos>	meet ( alice , alice ) <eos>	meet ( alice , alice ) <eos>
daniel sees grace <eos>	see ( daniel , grace ) <eos>	see ( daniel , grace ) <eos>
winnifred meets xerxes <eos>	meet ( winnifred , xerxes ) <eos>	meet ( winnifred , xerxes ) <eos>
patricia throws yvette <eos>	throw ( patricia , yvettte ) <eos>	throw ( patricia , yvettte ) <eos>
alice meets john <eos>	meet ( alice , john ) <eos>	meet ( alice , john ) <eos>
margaret throws ursula <eos>	throw ( margaret , ursula ) <eos>	throw ( margaret , ursula ) <eos>
patricia likes samuel <eos>	like ( patricia , samuel ) <eos>	like ( patricia , samuel ) <eos>
bob knows tracy <eos>	know ( bob , tracy ) <eos>	know ( bob , tracy ) <eos>
alice likes francis <eos>	like ( alice , francis ) <eos>	like ( alice , francis ) <eos>
yvette notices katherine <eos>	notice ( yvettte , katherine ) <eos>	notice ( yvettte , katherine ) <eos>
henry notices himself <eos>	notice ( henry , henry ) <eos>	notice ( henry , henry ) <eos>
samuel meets zelda <eos>	meet ( samuel , zelda ) <eos>	meet ( samuel , zelda ) <eos>
claire sees neha <eos>	see ( claire , neha ) <eos>	see ( claire , neha ) <eos>
francis dislikes daniel <eos>	dislike ( francis , daniel ) <eos>	dislike ( francis , daniel ) <eos>
yvette dislikes bob <eos>	dislike ( yvettte , bob ) <eos>	dislike ( yvettte , bob ) <eos>
daniel likes eliza <eos>	like ( daniel , eliza ) <eos>	like ( daniel , eliza ) <eos>
isla likes xerxes <eos>	like ( isla , xerxes ) <eos>	like ( isla , xerxes ) <eos>
quinn throws isla <eos>	throw ( quinn , isla ) <eos>	throw ( quinn , isla ) <eos>
ursula likes alice <eos>	like ( ursula , alice ) <eos>	like ( ursula , alice ) <eos>
samuel sees eliza <eos>	see ( samuel , eliza ) <eos>	see ( samuel , eliza ) <eos>
lewis likes yvette <eos>	like ( lewis , yvettte ) <eos>	like ( lewis , yvettte ) <eos>
isla notices victor <eos>	notice ( isla , victor ) <eos>	notice ( isla , victor ) <eos>
grace dislikes zelda <eos>	dislike ( grace , zelda ) <eos>	dislike ( grace , zelda ) <eos>
margaret meets eliza <eos>	meet ( margaret , eliza ) <eos>	meet ( margaret , eliza ) <eos>
eliza notices lewis <eos>	notice ( eliza , lewis ) <eos>	notice ( eliza , lewis ) <eos>
lewis dislikes rachael <eos>	dislike ( lewis , rachael ) <eos>	dislike ( lewis , rachael ) <eos>
oswald meets ursula <eos>	meet ( oswald , ursula ) <eos>	meet ( oswald , ursula ) <eos>
neha likes claire <eos>	like ( neha , claire ) <eos>	like ( neha , claire ) <eos>
oswald dislikes katherine <eos>	dislike ( oswald , katherine ) <eos>	dislike ( oswald , katherine ) <eos>
lewis likes grace <eos>	like ( lewis , grace ) <eos>	like ( lewis , grace ) <eos>
every actor throws samuel <eos>	all x . ( actor ( x ) -> throw ( x , samuel ) ) <eos>	all x . ( turtle ( x ) -> see ( x , samuel ) ) <eos>
every dog likes yvette <eos>	all x . ( dog ( x ) -> like ( x , yvettte ) ) <eos>	all x . ( dog ( x ) -> meet ( x , yvettte ) ) <eos>
everyone likes henry <eos>	all x . ( person ( x ) -> like ( x , henry ) ) <eos>	all x . ( person ( x ) -> notice ( x , henry ) ) <eos>
every actor notices margaret <eos>	all x . ( actor ( x ) -> notice ( x , margaret ) ) <eos>	all x . ( actor ( x ) -> meet ( x , margaret ) ) <eos>
every hoplite likes quinn <eos>	all x . ( hoplite ( x ) -> like ( x , quinn ) ) <eos>	all x . ( hoplite ( x ) -> meet ( x , quinn ) ) <eos>
every condor likes quinn <eos>	all x . ( condor ( x ) -> like ( x , quinn ) ) <eos>	all x . ( bear ( x ) -> dislike ( x , quinn ) ) <eos>
every dog sees victor <eos>	all x . ( dog ( x ) -> see ( x , victor ) ) <eos>	all x . ( dog ( x ) -> notice ( x , victor ) ) <eos>
every dog notices bob <eos>	all x . ( dog ( x ) -> notice ( x , bob ) ) <eos>	all x . ( dog ( x ) -> see ( x , bob ) ) <eos>
every prion knows daniel <eos>	all x . ( prion ( x ) -> know ( x , daniel ) ) <eos>	all x . ( dog ( x ) -> notice ( x , daniel ) ) <eos>
someone likes rachael <eos>	exists x . ( person ( x ) & like ( x , rachael ) ) <eos>	exists x . ( person ( x ) & like ( x , rachael ) ) <eos>
someone notices eliza <eos>	exists x . ( person ( x ) & notice ( x , eliza ) ) <eos>	exists x . ( person ( x ) & notice ( x , eliza ) ) <eos>
everyone sees margaret <eos>	all x . ( person ( x ) -> see ( x , margaret ) ) <eos>	all x . ( person ( x ) -> see ( x , margaret ) ) <eos>
every person sees yvette <eos>	all x . ( person ( x ) -> see ( x , yvettte ) ) <eos>	all x . ( person ( x ) -> see ( x , yvettte ) ) <eos>
every bear knows daniel <eos>	all x . ( bear ( x ) -> know ( x , daniel ) ) <eos>	all x . ( condor ( x ) -> notice ( x , daniel ) ) <eos>
every turtle notices katherine <eos>	all x . ( turtle ( x ) -> notice ( x , katherine ) ) <eos>	all x . ( turtle ( x ) -> see ( x , katherine ) ) <eos>
eliza knows yvette <eos>	know ( eliza , yvettte ) <eos>	know ( eliza , yvettte ) <eos>
xerxes notices yvette <eos>	notice ( xerxes , yvettte ) <eos>	notice ( xerxes , yvettte ) <eos>
daniel throws john <eos>	throw ( daniel , john ) <eos>	throw ( daniel , john ) <eos>
oswald sees grace <eos>	see ( oswald , grace ) <eos>	see ( oswald , grace ) <eos>
rachael meets xerxes <eos>	meet ( rachael , xerxes ) <eos>	meet ( rachael , xerxes ) <eos>
henry throws oswald <eos>	throw ( henry , oswald ) <eos>	throw ( henry , oswald ) <eos>
margaret throws daniel <eos>	throw ( margaret , daniel ) <eos>	throw ( margaret , daniel ) <eos>
lewis notices isla <eos>	notice ( lewis , isla ) <eos>	notice ( lewis , isla ) <eos>
katherine meets rachael <eos>	meet ( katherine , rachael ) <eos>	meet ( katherine , rachael ) <eos>
ursula sees victor <eos>	see ( ursula , victor ) <eos>	see ( ursula , victor ) <eos>
every turtle meets daniel <eos>	all x . ( turtle ( x ) -> meet ( x , daniel ) ) <eos>	all x . ( turtle ( x ) -> notice ( x , daniel ) ) <eos>
someone throws quinn <eos>	exists x . ( person ( x ) & throw ( x , quinn ) ) <eos>	exists x . ( person ( x ) & notice ( x , quinn ) ) <eos>
every turtle sees claire <eos>	all x . ( turtle ( x ) -> see ( x , claire ) ) <eos>	all x . ( turtle ( x ) -> throw ( x , claire ) ) <eos>
every bear meets oswald <eos>	all x . ( bear ( x ) -> meet ( x , oswald ) ) <eos>	all x . ( condor ( x ) -> see ( x , oswald ) ) <eos>
someone throws rachael <eos>	exists x . ( person ( x ) & throw ( x , rachael ) ) <eos>	exists x . ( person ( x ) & know ( x , rachael ) ) <eos>
francis sees patricia <eos>	see ( francis , patricia ) <eos>	see ( francis , patricia ) <eos>
isla notices claire <eos>	notice ( isla , claire ) <eos>	notice ( isla , claire ) <eos>
bob sees rachael <eos>	see ( bob , rachael ) <eos>	see ( bob , rachael ) <eos>
quinn throws victor <eos>	throw ( quinn , victor ) <eos>	throw ( quinn , victor ) <eos>
neha knows neha <eos>	know ( neha , neha ) <eos>	know ( neha , neha ) <eos>
every condor sees lewis <eos>	all x . ( condor ( x ) -> see ( x , lewis ) ) <eos>	all x . ( condor ( x ) -> throw ( x , lewis ) ) <eos>
every prion likes yvette <eos>	all x . ( prion ( x ) -> like ( x , yvettte ) ) <eos>	all x . ( prion ( x ) -> meet ( x , yvettte ) ) <eos>
every bear notices francis <eos>	all x . ( bear ( x ) -> notice ( x , francis ) ) <eos>	all x . ( condor ( x ) -> see ( x , francis ) ) <eos>
every bear notices patricia <eos>	all x . ( bear ( x ) -> notice ( x , patricia ) ) <eos>	all x . ( condor ( x ) -> throw ( x , patricia ) ) <eos>
every actor sings <eos>	all x . ( actor ( x ) -> sing ( x ) ) <eos>	all x . ( turtle ( x ) -> see ( x ) ) <eos>
neha meets alice <eos>	meet ( neha , alice ) <eos>	meet ( neha , alice ) <eos>
xerxes likes margaret <eos>	like ( xerxes , margaret ) <eos>	like ( xerxes , margaret ) <eos>
oswald notices john <eos>	notice ( oswald , john ) <eos>	notice ( oswald , john ) <eos>
henry meets himself <eos>	meet ( henry , henry ) <eos>	meet ( henry , henry ) <eos>
victor likes bob <eos>	like ( victor , bob ) <eos>	like ( victor , bob ) <eos>
margaret throws zelda <eos>	throw ( margaret , zelda ) <eos>	throw ( margaret , zelda ) <eos>
lewis notices tracy <eos>	notice ( lewis , tracy ) <eos>	notice ( lewis , tracy ) <eos>
daniel dislikes alice <eos>	dislike ( daniel , alice ) <eos>	dislike ( daniel , alice ) <eos>
daniel meets oswald <eos>	meet ( daniel , oswald ) <eos>	meet ( daniel , oswald ) <eos>
oswald knows katherine <eos>	know ( oswald , katherine ) <eos>	know ( oswald , katherine ) <eos>
isla throws katherine <eos>	throw ( isla , katherine ) <eos>	throw ( isla , katherine ) <eos>
margaret meets henry <eos>	meet ( margaret , henry ) <eos>	meet ( margaret , henry ) <eos>
tracy meets isla <eos>	meet ( tracy , isla ) <eos>	meet ( tracy , isla ) <eos>
zelda knows grace <eos>	know ( zelda , grace ) <eos>	know ( zelda , grace ) <eos>
tracy knows alice <eos>	know ( tracy , alice ) <eos>	know ( tracy , alice ) <eos>
margaret throws katherine <eos>	throw ( margaret , katherine ) <eos>	throw ( margaret , katherine ) <eos>
john dislikes oswald <eos>	dislike ( john , oswald ) <eos>	dislike ( john , oswald ) <eos>
margaret likes quinn <eos>	like ( margaret , quinn ) <eos>	like ( margaret , quinn ) <eos>
john likes himself <eos>	like ( john , john ) <eos>	like ( john , john ) <eos>
john knows ursula <eos>	know ( john , ursula ) <eos>	know ( john , ursula ) <eos>
patricia dislikes katherine <eos>	dislike ( patricia , katherine ) <eos>	dislike ( patricia , katherine ) <eos>
lewis notices henry <eos>	notice ( lewis , henry ) <eos>	notice ( lewis , henry ) <eos>
patricia throws tracy <eos>	throw ( patricia , tracy ) <eos>	throw ( patricia , tracy ) <eos>
katherine sees eliza <eos>	see ( katherine , eliza ) <eos>	see ( katherine , eliza ) <eos>
lewis likes lewis <eos>	like ( lewis , lewis ) <eos>	like ( lewis , lewis ) <eos>
neha throws john <eos>	throw ( neha , john ) <eos>	throw ( neha , john ) <eos>
quinn throws oswald <eos>	throw ( quinn , oswald ) <eos>	throw ( quinn , oswald ) <eos>
grace likes winnifred <eos>	like ( grace , winnifred ) <eos>	like ( grace , winnifred ) <eos>
victor throws rachael <eos>	throw ( victor , rachael ) <eos>	throw ( victor , rachael ) <eos>
isla dislikes zelda <eos>	dislike ( isla , zelda ) <eos>	dislike ( isla , zelda ) <eos>
every turtle dislikes herself <eos>	all x . ( turtle ( x ) -> dislike ( x , x ) ) <eos>	all x . ( turtle ( x ) -> see ( x , claire ) ) <eos>
every turtle meets henry <eos>	all x . ( turtle ( x ) -> meet ( x , henry ) ) <eos>	all x . ( turtle ( x ) -> notice ( x , henry ) ) <eos>
every turtle likes samuel <eos>	all x . ( turtle ( x ) -> like ( x , samuel ) ) <eos>	all x . ( turtle ( x ) -> see ( x , samuel ) ) <eos>
every dog knows alice <eos>	all x . ( dog ( x ) -> know ( x , alice ) ) <eos>	all x . ( prion ( x ) -> meet ( x , alice ) ) <eos>
everyone dislikes yvette <eos>	all x . ( person ( x ) -> dislike ( x , yvettte ) ) <eos>	all x . ( person ( x ) -> see ( x , x ) ) <eos>
victor sees tracy <eos>	see ( victor , tracy ) <eos>	see ( victor , tracy ) <eos>
bob throws bob <eos>	throw ( bob , bob ) <eos>	throw ( bob , bob ) <eos>
claire dislikes oswald <eos>	dislike ( claire , oswald ) <eos>	dislike ( claire , oswald ) <eos>
oswald sees katherine <eos>	see ( oswald , katherine ) <eos>	see ( oswald , katherine ) <eos>
daniel throws alice <eos>	throw ( daniel , alice ) <eos>	throw ( daniel , alice ) <eos>
xerxes knows lewis <eos>	know ( xerxes , lewis ) <eos>	know ( xerxes , lewis ) <eos>
ursula sees xerxes <eos>	see ( ursula , xerxes ) <eos>	see ( ursula , xerxes ) <eos>
john meets alice <eos>	meet ( john , alice ) <eos>	meet ( john , alice ) <eos>
eliza sees xerxes <eos>	see ( eliza , xerxes ) <eos>	see ( eliza , xerxes ) <eos>
claire notices francis <eos>	notice ( claire , francis ) <eos>	notice ( claire , francis ) <eos>
every dog meets xerxes <eos>	all x . ( dog ( x ) -> meet ( x , xerxes ) ) <eos>	all x . ( dog ( x ) -> notice ( x , xerxes ) ) <eos>
every condor knows winnifred <eos>	all x . ( condor ( x ) -> know ( x , winnifred ) ) <eos>	all x . ( bear ( x ) -> like ( x , winnifred ) ) <eos>
every condor notices tracy <eos>	all x . ( condor ( x ) -> notice ( x , tracy ) ) <eos>	all x . ( condor ( x ) -> notice ( x , tracy ) ) <eos>
every hoplite throws zelda <eos>	all x . ( hoplite ( x ) -> throw ( x , zelda ) ) <eos>	all x . ( hoplite ( x ) -> notice ( x , zelda ) ) <eos>
every bear dislikes lewis <eos>	all x . ( bear ( x ) -> dislike ( x , lewis ) ) <eos>	all x . ( condor ( x ) -> throw ( x , lewis ) ) <eos>
every bear likes katherine <eos>	all x . ( bear ( x ) -> like ( x , katherine ) ) <eos>	all x . ( bear ( x ) -> meet ( x , katherine ) ) <eos>
everyone notices katherine <eos>	all x . ( person ( x ) -> notice ( x , katherine ) ) <eos>	all x . ( person ( x ) -> like ( x , katherine ) ) <eos>
every actor throws eliza <eos>	all x . ( actor ( x ) -> throw ( x , eliza ) ) <eos>	all x . ( actor ( x ) -> throw ( x , eliza ) ) <eos>
every prion dislikes winnifred <eos>	all x . ( prion ( x ) -> dislike ( x , winnifred ) ) <eos>	all x . ( prion ( x ) -> see ( x , winnifred ) ) <eos>
every turtle sees neha <eos>	all x . ( turtle ( x ) -> see ( x , neha ) ) <eos>	all x . ( turtle ( x ) -> throw ( x , neha ) ) <eos>
katherine sees xerxes <eos>	see ( katherine , xerxes ) <eos>	see ( katherine , xerxes ) <eos>
samuel dislikes eliza <eos>	dislike ( samuel , eliza ) <eos>	dislike ( samuel , eliza ) <eos>
grace meets john <eos>	meet ( grace , john ) <eos>	meet ( grace , john ) <eos>
bob meets alice <eos>	meet ( bob , alice ) <eos>	meet ( bob , alice ) <eos>
neha dislikes grace <eos>	dislike ( neha , grace ) <eos>	dislike ( neha , grace ) <eos>
lewis notices francis <eos>	notice ( lewis , francis ) <eos>	notice ( lewis , francis ) <eos>
oswald notices isla <eos>	notice ( oswald , isla ) <eos>	notice ( oswald , isla ) <eos>
samuel meets xerxes <eos>	meet ( samuel , xerxes ) <eos>	meet ( samuel , xerxes ) <eos>
ursula notices ursula <eos>	notice ( ursula , ursula ) <eos>	notice ( ursula , ursula ) <eos>
victor eats <eos>	eat ( victor ) <eos>	eat ( victor ) <eos>
eliza throws neha <eos>	throw ( eliza , neha ) <eos>	throw ( eliza , neha ) <eos>
katherine throws henry <eos>	throw ( katherine , henry ) <eos>	throw ( katherine , henry ) <eos>
john sees bob <eos>	see ( john , bob ) <eos>	see ( john , bob ) <eos>
john sees francis <eos>	see ( john , francis ) <eos>	see ( john , francis ) <eos>
rachael notices xerxes <eos>	notice ( rachael , xerxes ) <eos>	notice ( rachael , xerxes ) <eos>
isla likes alice <eos>	like ( isla , alice ) <eos>	like ( isla , alice ) <eos>
xerxes knows john <eos>	know ( xerxes , john ) <eos>	know ( xerxes , john ) <eos>
yvette meets grace <eos>	meet ( yvettte , grace ) <eos>	meet ( yvettte , grace ) <eos>
xerxes likes winnifred <eos>	like ( xerxes , winnifred ) <eos>	like ( xerxes , winnifred ) <eos>
victor notices ursula <eos>	notice ( victor , ursula ) <eos>	notice ( victor , ursula ) <eos>
every person throws yvette <eos>	all x . ( person ( x ) -> throw ( x , yvettte ) ) <eos>	all x . ( person ( x ) -> see ( x , yvettte ) ) <eos>
every prion likes herself <eos>	all x . ( prion ( x ) -> like ( x , x ) ) <eos>	all x . ( bear ( x ) -> see ( x , x ) ) <eos>
every person dislikes neha <eos>	all x . ( person ( x ) -> dislike ( x , neha ) ) <eos>	all x . ( person ( x ) -> throw ( x , neha ) ) <eos>
every person throws claire <eos>	all x . ( person ( x ) -> throw ( x , claire ) ) <eos>	all x . ( person ( x ) -> see ( x , claire ) ) <eos>
every hoplite dislikes tracy <eos>	all x . ( hoplite ( x ) -> dislike ( x , tracy ) ) <eos>	all x . ( hoplite ( x ) -> notice ( x , tracy ) ) <eos>
katherine meets zelda <eos>	meet ( katherine , zelda ) <eos>	meet ( katherine , zelda ) <eos>
xerxes likes alice <eos>	like ( xerxes , alice ) <eos>	like ( xerxes , alice ) <eos>
claire throws quinn <eos>	throw ( claire , quinn ) <eos>	throw ( claire , quinn ) <eos>
alice notices henry <eos>	notice ( alice , henry ) <eos>	notice ( alice , henry ) <eos>
bob likes francis <eos>	like ( bob , francis ) <eos>	like ( bob , francis ) <eos>
winnifred likes eliza <eos>	like ( winnifred , eliza ) <eos>	like ( winnifred , eliza ) <eos>
ursula throws ursula <eos>	throw ( ursula , ursula ) <eos>	throw ( ursula , ursula ) <eos>
ursula notices claire <eos>	notice ( ursula , claire ) <eos>	notice ( ursula , claire ) <eos>
isla meets lewis <eos>	meet ( isla , lewis ) <eos>	meet ( isla , lewis ) <eos>
bob throws grace <eos>	throw ( bob , grace ) <eos>	throw ( bob , grace ) <eos>
francis meets bob <eos>	meet ( francis , bob ) <eos>	meet ( francis , bob ) <eos>
margaret dislikes margaret <eos>	dislike ( margaret , margaret ) <eos>	dislike ( margaret , margaret ) <eos>
alice notices xerxes <eos>	notice ( alice , xerxes ) <eos>	notice ( alice , xerxes ) <eos>
katherine notices quinn <eos>	notice ( katherine , quinn ) <eos>	notice ( katherine , quinn ) <eos>
tracy likes claire <eos>	like ( tracy , claire ) <eos>	like ( tracy , claire ) <eos>
isla throws quinn <eos>	throw ( isla , quinn ) <eos>	throw ( isla , quinn ) <eos>
lewis throws rachael <eos>	throw ( lewis , rachael ) <eos>	throw ( lewis , rachael ) <eos>
eliza likes victor <eos>	like ( eliza , victor ) <eos>	like ( eliza , victor ) <eos>
yvette likes francis <eos>	like ( yvettte , francis ) <eos>	like ( yvettte , francis ) <eos>
francis knows grace <eos>	know ( francis , grace ) <eos>	know ( francis , grace ) <eos>
winnifred meets samuel <eos>	meet ( winnifred , samuel ) <eos>	meet ( winnifred , samuel ) <eos>
yvette likes alice <eos>	like ( yvettte , alice ) <eos>	like ( yvettte , alice ) <eos>
henry notices bob <eos>	notice ( henry , bob ) <eos>	notice ( henry , bob ) <eos>
henry notices claire <eos>	notice ( henry , claire ) <eos>	notice ( henry , claire ) <eos>
daniel knows victor <eos>	know ( daniel , victor ) <eos>	know ( daniel , victor ) <eos>
yvette meets quinn <eos>	meet ( yvettte , quinn ) <eos>	meet ( yvettte , quinn ) <eos>
victor likes samuel <eos>	like ( victor , samuel ) <eos>	like ( victor , samuel ) <eos>
zelda likes quinn <eos>	like ( zelda , quinn ) <eos>	like ( zelda , quinn ) <eos>
grace notices zelda <eos>	notice ( grace , zelda ) <eos>	notice ( grace , zelda ) <eos>
winnifred meets oswald <eos>	meet ( winnifred , oswald ) <eos>	meet ( winnifred , oswald ) <eos>
someone sees rachael <eos>	exists x . ( person ( x ) & see ( x , rachael ) ) <eos>	exists x . ( person ( x ) & like ( x , rachael ) ) <eos>
someone throws isla <eos>	exists x . ( person ( x ) & throw ( x , isla ) ) <eos>	exists x . ( person ( x ) & meet ( x , isla ) ) <eos>
someone notices grace <eos>	exists x . ( person ( x ) & notice ( x , grace ) ) <eos>	exists x . ( person ( x ) & like ( x , grace ) ) <eos>
every turtle notices lewis <eos>	all x . ( turtle ( x ) -> notice ( x , lewis ) ) <eos>	all x . ( turtle ( x ) -> throw ( x , lewis ) ) <eos>
every dog throws margaret <eos>	all x . ( dog ( x ) -> throw ( x , margaret ) ) <eos>	all x . ( dog ( x ) -> meet ( x , margaret ) ) <eos>
patricia meets francis <eos>	meet ( patricia , francis ) <eos>	meet ( patricia , francis ) <eos>
eliza notices isla <eos>	notice ( eliza , isla ) <eos>	notice ( eliza , isla ) <eos>
margaret throws alice <eos>	throw ( margaret , alice ) <eos>	throw ( margaret , alice ) <eos>
ursula meets yvette <eos>	meet ( ursula , yvettte ) <eos>	meet ( ursula , yvettte ) <eos>
rachael meets katherine <eos>	meet ( rachael , katherine ) <eos>	meet ( rachael , katherine ) <eos>
every turtle throws ursula <eos>	all x . ( turtle ( x ) -> throw ( x , ursula ) ) <eos>	all x . ( turtle ( x ) -> see ( x , ursula ) ) <eos>
everyone dislikes lewis <eos>	all x . ( person ( x ) -> dislike ( x , lewis ) ) <eos>	all x . ( person ( x ) -> throw ( x , lewis ) ) <eos>
every prion meets lewis <eos>	all x . ( prion ( x ) -> meet ( x , lewis ) ) <eos>	all x . ( prion ( x ) -> throw ( x , lewis ) ) <eos>
every hoplite likes zelda <eos>	all x . ( hoplite ( x ) -> like ( x , zelda ) ) <eos>	all x . ( hoplite ( x ) -> notice ( x , zelda ) ) <eos>
every condor dislikes daniel <eos>	all x . ( condor ( x ) -> dislike ( x , daniel ) ) <eos>	all x . ( condor ( x ) -> see ( x , daniel ) ) <eos>
neha dislikes quinn <eos>	dislike ( neha , quinn ) <eos>	dislike ( neha , quinn ) <eos>
neha meets zelda <eos>	meet ( neha , zelda ) <eos>	meet ( neha , zelda ) <eos>
isla notices grace <eos>	notice ( isla , grace ) <eos>	notice ( isla , grace ) <eos>
katherine knows oswald <eos>	know ( katherine , oswald ) <eos>	know ( katherine , oswald ) <eos>
rachael knows zelda <eos>	know ( rachael , zelda ) <eos>	know ( rachael , zelda ) <eos>
victor meets quinn <eos>	meet ( victor , quinn ) <eos>	meet ( victor , quinn ) <eos>
xerxes dislikes margaret <eos>	dislike ( xerxes , margaret ) <eos>	dislike ( xerxes , margaret ) <eos>
daniel throws tracy <eos>	throw ( daniel , tracy ) <eos>	throw ( daniel , tracy ) <eos>
john meets francis <eos>	meet ( john , francis ) <eos>	meet ( john , francis ) <eos>
isla sees katherine <eos>	see ( isla , katherine ) <eos>	see ( isla , katherine ) <eos>
alice likes patricia <eos>	like ( alice , patricia ) <eos>	like ( alice , patricia ) <eos>
neha notices victor <eos>	notice ( neha , victor ) <eos>	notice ( neha , victor ) <eos>
patricia notices quinn <eos>	notice ( patricia , quinn ) <eos>	notice ( patricia , quinn ) <eos>
alice meets rachael <eos>	meet ( alice , rachael ) <eos>	meet ( alice , rachael ) <eos>
john meets winnifred <eos>	meet ( john , winnifred ) <eos>	meet ( john , winnifred ) <eos>
every bear throws tracy <eos>	all x . ( bear ( x ) -> throw ( x , tracy ) ) <eos>	all x . ( condor ( x ) -> notice ( x , tracy ) ) <eos>
every turtle knows john <eos>	all x . ( turtle ( x ) -> know ( x , john ) ) <eos>	all x . ( turtle ( x ) -> meet ( x , john ) ) <eos>
every person knows daniel <eos>	all x . ( person ( x ) -> know ( x , daniel ) ) <eos>	all x . ( person ( x ) -> notice ( x , daniel ) ) <eos>
every turtle knows daniel <eos>	all x . ( turtle ( x ) -> know ( x , daniel ) ) <eos>	all x . ( turtle ( x ) -> notice ( x , daniel ) ) <eos>
someone dislikes eliza <eos>	exists x . ( person ( x ) & dislike ( x , eliza ) ) <eos>	exists x . ( person ( x ) & see ( x , eliza ) ) <eos>
every person likes isla <eos>	all x . ( person ( x ) -> like ( x , isla ) ) <eos>	all x . ( person ( x ) -> meet ( x , isla ) ) <eos>
every dog knows eliza <eos>	all x . ( dog ( x ) -> know ( x , eliza ) ) <eos>	all x . ( dog ( x ) -> notice ( x , eliza ) ) <eos>
every dog likes claire <eos>	all x . ( dog ( x ) -> like ( x , claire ) ) <eos>	all x . ( dog ( x ) -> see ( x , claire ) ) <eos>
every condor meets grace <eos>	all x . ( condor ( x ) -> meet ( x , grace ) ) <eos>	all x . ( bear ( x ) -> see ( x , grace ) ) <eos>
every actor sees eliza <eos>	all x . ( actor ( x ) -> see ( x , eliza ) ) <eos>	all x . ( actor ( x ) -> throw ( x , eliza ) ) <eos>
everyone throws henry <eos>	all x . ( person ( x ) -> throw ( x , henry ) ) <eos>	all x . ( person ( x ) -> notice ( x , henry ) ) <eos>
every prion knows henry <eos>	all x . ( prion ( x ) -> know ( x , henry ) ) <eos>	all x . ( dog ( x ) -> meet ( x , henry ) ) <eos>
every dog dislikes patricia <eos>	all x . ( dog ( x ) -> dislike ( x , patricia ) ) <eos>	all x . ( prion ( x ) -> throw ( x , patricia ) ) <eos>
every turtle dislikes katherine <eos>	all x . ( turtle ( x ) -> dislike ( x , katherine ) ) <eos>	all x . ( turtle ( x ) -> meet ( x , katherine ) ) <eos>
everyone dislikes bob <eos>	all x . ( person ( x ) -> dislike ( x , bob ) ) <eos>	all x . ( person ( x ) -> see ( x , bob ) ) <eos>
every actor sees yvette <eos>	all x . ( actor ( x ) -> see ( x , yvettte ) ) <eos>	all x . ( actor ( x ) -> meet ( x , yvettte ) ) <eos>
every prion likes himself <eos>	all x . ( prion ( x ) -> like ( x , x ) ) <eos>	all x . ( bear ( x ) -> see ( x , x ) ) <eos>
every dog likes patricia <eos>	all x . ( dog ( x ) -> like ( x , patricia ) ) <eos>	all x . ( prion ( x ) -> throw ( x , patricia ) ) <eos>
someone meets yvette <eos>	exists x . ( person ( x ) & meet ( x , yvettte ) ) <eos>	exists x . ( person ( x ) & meet ( x , yvettte ) ) <eos>
everyone meets yvette <eos>	all x . ( person ( x ) -> meet ( x , yvettte ) ) <eos>	all x . ( person ( x ) -> see ( x , yvettte ) ) <eos>
patricia meets oswald <eos>	meet ( patricia , oswald ) <eos>	meet ( patricia , oswald ) <eos>
claire sees john <eos>	see ( claire , john ) <eos>	see ( claire , john ) <eos>
neha dislikes katherine <eos>	dislike ( neha , katherine ) <eos>	dislike ( neha , katherine ) <eos>
margaret likes daniel <eos>	like ( margaret , daniel ) <eos>	like ( margaret , daniel ) <eos>
katherine dislikes margaret <eos>	dislike ( katherine , margaret ) <eos>	dislike ( katherine , margaret ) <eos>
eliza dislikes rachael <eos>	dislike ( eliza , rachael ) <eos>	dislike ( eliza , rachael ) <eos>
tracy meets daniel <eos>	meet ( tracy , daniel ) <eos>	meet ( tracy , daniel ) <eos>
quinn knows john <eos>	know ( quinn , john ) <eos>	know ( quinn , john ) <eos>
john throws neha <eos>	throw ( john , neha ) <eos>	throw ( john , neha ) <eos>
alice knows grace <eos>	know ( alice , grace ) <eos>	know ( alice , grace ) <eos>
every dog likes ursula <eos>	all x . ( dog ( x ) -> like ( x , ursula ) ) <eos>	all x . ( dog ( x ) -> see ( x , ursula ) ) <eos>
every bear throws zelda <eos>	all x . ( bear ( x ) -> throw ( x , zelda ) ) <eos>	all x . ( bear ( x ) -> notice ( x , zelda ) ) <eos>
every bear sees john <eos>	all x . ( bear ( x ) -> see ( x , john ) ) <eos>	all x . ( condor ( x ) -> see ( x , john ) ) <eos>
every turtle meets alice <eos>	all x . ( turtle ( x ) -> meet ( x , alice ) ) <eos>	all x . ( turtle ( x ) -> meet ( x , alice ) ) <eos>
every dog dislikes rachael <eos>	all x . ( dog ( x ) -> dislike ( x , rachael ) ) <eos>	all x . ( dog ( x ) -> meet ( x , rachael ) ) <eos>
tracy throws john <eos>	throw ( tracy , john ) <eos>	throw ( tracy , john ) <eos>
tracy throws katherine <eos>	throw ( tracy , katherine ) <eos>	throw ( tracy , katherine ) <eos>
winnifred meets henry <eos>	meet ( winnifred , henry ) <eos>	meet ( winnifred , henry ) <eos>
lewis notices tracy <eos>	notice ( lewis , tracy ) <eos>	notice ( lewis , tracy ) <eos>
oswald sees bob <eos>	see ( oswald , bob ) <eos>	see ( oswald , bob ) <eos>
every turtle knows ursula <eos>	all x . ( turtle ( x ) -> know ( x , ursula ) ) <eos>	all x . ( turtle ( x ) -> see ( x , ursula ) ) <eos>
every condor sees ursula <eos>	all x . ( condor ( x ) -> see ( x , ursula ) ) <eos>	all x . ( bear ( x ) -> see ( x , ursula ) ) <eos>
every prion throws yvette <eos>	all x . ( prion ( x ) -> throw ( x , yvettte ) ) <eos>	all x . ( prion ( x ) -> meet ( x , yvettte ) ) <eos>
every prion meets himself <eos>	all x . ( prion ( x ) -> meet ( x , x ) ) <eos>	all x . ( dog ( x ) -> notice ( x , x ) ) <eos>
everyone notices eliza <eos>	all x . ( person ( x ) -> notice ( x , eliza ) ) <eos>	all x . ( person ( x ) -> notice ( x , eliza ) ) <eos>
patricia likes margaret <eos>	like ( patricia , margaret ) <eos>	like ( patricia , margaret ) <eos>
john meets patricia <eos>	meet ( john , patricia ) <eos>	meet ( john , patricia ) <eos>
daniel meets margaret <eos>	meet ( daniel , margaret ) <eos>	meet ( daniel , margaret ) <eos>
alice throws rachael <eos>	throw ( alice , rachael ) <eos>	throw ( alice , rachael ) <eos>
winnifred notices zelda <eos>	notice ( winnifred , zelda ) <eos>	notice ( winnifred , zelda ) <eos>
margaret knows claire <eos>	know ( margaret , claire ) <eos>	know ( margaret , claire ) <eos>
oswald dislikes grace <eos>	dislike ( oswald , grace ) <eos>	dislike ( oswald , grace ) <eos>
eliza knows herself <eos>	know ( eliza , eliza ) <eos>	know ( eliza , eliza ) <eos>
margaret notices neha <eos>	notice ( margaret , neha ) <eos>	notice ( margaret , neha ) <eos>
grace meets rachael <eos>	meet ( grace , rachael ) <eos>	meet ( grace , rachael ) <eos>
eliza likes rachael <eos>	like ( eliza , rachael ) <eos>	like ( eliza , rachael ) <eos>
winnifred knows samuel <eos>	know ( winnifred , samuel ) <eos>	know ( winnifred , samuel ) <eos>
zelda meets katherine <eos>	meet ( zelda , katherine ) <eos>	meet ( zelda , katherine ) <eos>
zelda dislikes xerxes <eos>	dislike ( zelda , xerxes ) <eos>	dislike ( zelda , xerxes ) <eos>
alice sees samuel <eos>	see ( alice , samuel ) <eos>	see ( alice , samuel ) <eos>
isla knows francis <eos>	know ( isla , francis ) <eos>	know ( isla , francis ) <eos>
winnifred dislikes francis <eos>	dislike ( winnifred , francis ) <eos>	dislike ( winnifred , francis ) <eos>
henry knows yvette <eos>	know ( henry , yvettte ) <eos>	know ( henry , yvettte ) <eos>
tracy knows ursula <eos>	know ( tracy , ursula ) <eos>	know ( tracy , ursula ) <eos>
isla sees john <eos>	see ( isla , john ) <eos>	see ( isla , john ) <eos>
tracy likes yvette <eos>	like ( tracy , yvettte ) <eos>	like ( tracy , yvettte ) <eos>
zelda throws yvette <eos>	throw ( zelda , yvettte ) <eos>	throw ( zelda , yvettte ) <eos>
daniel throws zelda <eos>	throw ( daniel , zelda ) <eos>	throw ( daniel , zelda ) <eos>
claire likes katherine <eos>	like ( claire , katherine ) <eos>	like ( claire , katherine ) <eos>
isla knows yvette <eos>	know ( isla , yvettte ) <eos>	know ( isla , yvettte ) <eos>
margaret dislikes patricia <eos>	dislike ( margaret , patricia ) <eos>	dislike ( margaret , patricia ) <eos>
alice meets eliza <eos>	meet ( alice , eliza ) <eos>	meet ( alice , eliza ) <eos>
alice throws grace <eos>	throw ( alice , grace ) <eos>	throw ( alice , grace ) <eos>
eliza notices victor <eos>	notice ( eliza , victor ) <eos>	notice ( eliza , victor ) <eos>
quinn meets margaret <eos>	meet ( quinn , margaret ) <eos>	meet ( quinn , margaret ) <eos>
winnifred likes rachael <eos>	like ( winnifred , rachael ) <eos>	like ( winnifred , rachael ) <eos>
isla throws isla <eos>	throw ( isla , isla ) <eos>	throw ( isla , isla ) <eos>
patricia sees isla <eos>	see ( patricia , isla ) <eos>	see ( patricia , isla ) <eos>
xerxes likes patricia <eos>	like ( xerxes , patricia ) <eos>	like ( xerxes , patricia ) <eos>
katherine likes ursula <eos>	like ( katherine , ursula ) <eos>	like ( katherine , ursula ) <eos>
neha knows yvette <eos>	know ( neha , yvettte ) <eos>	know ( neha , yvettte ) <eos>
claire dislikes isla <eos>	dislike ( claire , isla ) <eos>	dislike ( claire , isla ) <eos>
oswald sees lewis <eos>	see ( oswald , lewis ) <eos>	see ( oswald , lewis ) <eos>
grace sees daniel <eos>	see ( grace , daniel ) <eos>	see ( grace , daniel ) <eos>
john sees winnifred <eos>	see ( john , winnifred ) <eos>	see ( john , winnifred ) <eos>
daniel throws quinn <eos>	throw ( daniel , quinn ) <eos>	throw ( daniel , quinn ) <eos>
eliza sees victor <eos>	see ( eliza , victor ) <eos>	see ( eliza , victor ) <eos>
daniel knows rachael <eos>	know ( daniel , rachael ) <eos>	know ( daniel , rachael ) <eos>
patricia notices daniel <eos>	notice ( patricia , daniel ) <eos>	notice ( patricia , daniel ) <eos>
neha dislikes lewis <eos>	dislike ( neha , lewis ) <eos>	dislike ( neha , lewis ) <eos>
yvette notices winnifred <eos>	notice ( yvettte , winnifred ) <eos>	notice ( yvettte , winnifred ) <eos>
bob meets yvette <eos>	meet ( bob , yvettte ) <eos>	meet ( bob , yvettte ) <eos>
neha meets alice <eos>	meet ( neha , alice ) <eos>	meet ( neha , alice ) <eos>
francis throws oswald <eos>	throw ( francis , oswald ) <eos>	throw ( francis , oswald ) <eos>
patricia likes oswald <eos>	like ( patricia , oswald ) <eos>	like ( patricia , oswald ) <eos>
every turtle notices katherine <eos>	all x . ( turtle ( x ) -> notice ( x , katherine ) ) <eos>	all x . ( turtle ( x ) -> see ( x , katherine ) ) <eos>
every prion meets katherine <eos>	all x . ( prion ( x ) -> meet ( x , katherine ) ) <eos>	all x . ( prion ( x ) -> meet ( x , katherine ) ) <eos>
every hoplite knows alice <eos>	all x . ( hoplite ( x ) -> know ( x , alice ) ) <eos>	all x . ( hoplite ( x ) -> see ( x , alice ) ) <eos>
every dog meets alice <eos>	all x . ( dog ( x ) -> meet ( x , alice ) ) <eos>	all x . ( dog ( x ) -> meet ( x , alice ) ) <eos>
every condor likes xerxes <eos>	all x . ( condor ( x ) -> like ( x , xerxes ) ) <eos>	all x . ( bear ( x ) -> notice ( x , xerxes ) ) <eos>
grace notices bob <eos>	notice ( grace , bob ) <eos>	notice ( grace , bob ) <eos>
quinn dislikes henry <eos>	dislike ( quinn , henry ) <eos>	dislike ( quinn , henry ) <eos>
francis meets isla <eos>	meet ( francis , isla ) <eos>	meet ( francis , isla ) <eos>
daniel notices alice <eos>	notice ( daniel , alice ) <eos>	notice ( daniel , alice ) <eos>
katherine knows isla <eos>	know ( katherine , isla ) <eos>	know ( katherine , isla ) <eos>
henry walks <eos>	walk ( henry ) <eos>	walk ( henry ) <eos>
xerxes runs <eos>	run ( xerxes ) <eos>	run ( xerxes ) <eos>
rachael eats <eos>	eat ( rachael ) <eos>	eat ( rachael ) <eos>
john eats <eos>	eat ( john ) <eos>	eat ( john ) <eos>
henry runs <eos>	run ( henry ) <eos>	run ( henry ) <eos>
claire knows lewis <eos>	know ( claire , lewis ) <eos>	know ( claire , lewis ) <eos>
isla throws winnifred <eos>	throw ( isla , winnifred ) <eos>	throw ( isla , winnifred ) <eos>
john knows isla <eos>	know ( john , isla ) <eos>	know ( john , isla ) <eos>
katherine sees claire <eos>	see ( katherine , claire ) <eos>	see ( katherine , claire ) <eos>
francis throws ursula <eos>	throw ( francis , ursula ) <eos>	throw ( francis , ursula ) <eos>
every hoplite sees yvette <eos>	all x . ( hoplite ( x ) -> see ( x , yvettte ) ) <eos>	all x . ( hoplite ( x ) -> meet ( x , yvettte ) ) <eos>
everyone sees bob <eos>	all x . ( person ( x ) -> see ( x , bob ) ) <eos>	all x . ( person ( x ) -> see ( x , bob ) ) <eos>
every actor knows patricia <eos>	all x . ( actor ( x ) -> know ( x , patricia ) ) <eos>	all x . ( actor ( x ) -> throw ( x , patricia ) ) <eos>
every condor knows katherine <eos>	all x . ( condor ( x ) -> know ( x , katherine ) ) <eos>	all x . ( bear ( x ) -> see ( x , katherine ) ) <eos>
every turtle sees ursula <eos>	all x . ( turtle ( x ) -> see ( x , ursula ) ) <eos>	all x . ( turtle ( x ) -> see ( x , ursula ) ) <eos>
tracy knows eliza <eos>	know ( tracy , eliza ) <eos>	know ( tracy , eliza ) <eos>
neha knows lewis <eos>	know ( neha , lewis ) <eos>	know ( neha , lewis ) <eos>
xerxes likes isla <eos>	like ( xerxes , isla ) <eos>	like ( xerxes , isla ) <eos>
samuel meets henry <eos>	meet ( samuel , henry ) <eos>	meet ( samuel , henry ) <eos>
john sees grace <eos>	see ( john , grace ) <eos>	see ( john , grace ) <eos>
someone meets himself <eos>	exists x . ( person ( x ) & meet ( x , x ) ) <eos>	exists x . ( person ( x ) & see ( x , x ) ) <eos>
every prion notices katherine <eos>	all x . ( prion ( x ) -> notice ( x , katherine ) ) <eos>	all x . ( prion ( x ) -> meet ( x , katherine ) ) <eos>
every condor throws ursula <eos>	all x . ( condor ( x ) -> throw ( x , ursula ) ) <eos>	all x . ( bear ( x ) -> see ( x , ursula ) ) <eos>
every hoplite dislikes grace <eos>	all x . ( hoplite ( x ) -> dislike ( x , grace ) ) <eos>	all x . ( hoplite ( x ) -> see ( x , grace ) ) <eos>
every hoplite sees neha <eos>	all x . ( hoplite ( x ) -> see ( x , neha ) ) <eos>	all x . ( hoplite ( x ) -> throw ( x , neha ) ) <eos>
margaret sees francis <eos>	see ( margaret , francis ) <eos>	see ( margaret , francis ) <eos>
isla meets claire <eos>	meet ( isla , claire ) <eos>	meet ( isla , claire ) <eos>
samuel likes xerxes <eos>	like ( samuel , xerxes ) <eos>	like ( samuel , xerxes ) <eos>
oswald notices quinn <eos>	notice ( oswald , quinn ) <eos>	notice ( oswald , quinn ) <eos>
winnifred meets xerxes <eos>	meet ( winnifred , xerxes ) <eos>	meet ( winnifred , xerxes ) <eos>
john likes victor <eos>	like ( john , victor ) <eos>	like ( john , victor ) <eos>
francis throws eliza <eos>	throw ( francis , eliza ) <eos>	throw ( francis , eliza ) <eos>
daniel dislikes tracy <eos>	dislike ( daniel , tracy ) <eos>	dislike ( daniel , tracy ) <eos>
neha likes grace <eos>	like ( neha , grace ) <eos>	like ( neha , grace ) <eos>
samuel knows claire <eos>	know ( samuel , claire ) <eos>	know ( samuel , claire ) <eos>
winnifred sees grace <eos>	see ( winnifred , grace ) <eos>	see ( winnifred , grace ) <eos>
margaret meets margaret <eos>	meet ( margaret , margaret ) <eos>	meet ( margaret , margaret ) <eos>
zelda meets xerxes <eos>	meet ( zelda , xerxes ) <eos>	meet ( zelda , xerxes ) <eos>
bob sees henry <eos>	see ( bob , henry ) <eos>	see ( bob , henry ) <eos>
samuel notices ursula <eos>	notice ( samuel , ursula ) <eos>	notice ( samuel , ursula ) <eos>
xerxes sees margaret <eos>	see ( xerxes , margaret ) <eos>	see ( xerxes , margaret ) <eos>
victor knows john <eos>	know ( victor , john ) <eos>	know ( victor , john ) <eos>
rachael throws alice <eos>	throw ( rachael , alice ) <eos>	throw ( rachael , alice ) <eos>
margaret throws quinn <eos>	throw ( margaret , quinn ) <eos>	throw ( margaret , quinn ) <eos>
eliza sees neha <eos>	see ( eliza , neha ) <eos>	see ( eliza , neha ) <eos>
oswald dislikes xerxes <eos>	dislike ( oswald , xerxes ) <eos>	dislike ( oswald , xerxes ) <eos>
francis sees yvette <eos>	see ( francis , yvettte ) <eos>	see ( francis , yvettte ) <eos>
alice meets francis <eos>	meet ( alice , francis ) <eos>	meet ( alice , francis ) <eos>
margaret likes francis <eos>	like ( margaret , francis ) <eos>	like ( margaret , francis ) <eos>
rachael meets oswald <eos>	meet ( rachael , oswald ) <eos>	meet ( rachael , oswald ) <eos>
every bear dislikes neha <eos>	all x . ( bear ( x ) -> dislike ( x , neha ) ) <eos>	all x . ( bear ( x ) -> throw ( x , neha ) ) <eos>
every turtle notices francis <eos>	all x . ( turtle ( x ) -> notice ( x , francis ) ) <eos>	all x . ( turtle ( x ) -> meet ( x , francis ) ) <eos>
every dog likes samuel <eos>	all x . ( dog ( x ) -> like ( x , samuel ) ) <eos>	all x . ( prion ( x ) -> see ( x , samuel ) ) <eos>
every hoplite meets yvette <eos>	all x . ( hoplite ( x ) -> meet ( x , yvettte ) ) <eos>	all x . ( hoplite ( x ) -> meet ( x , yvettte ) ) <eos>
every dog notices margaret <eos>	all x . ( dog ( x ) -> notice ( x , margaret ) ) <eos>	all x . ( dog ( x ) -> meet ( x , margaret ) ) <eos>
every person meets katherine <eos>	all x . ( person ( x ) -> meet ( x , katherine ) ) <eos>	all x . ( person ( x ) -> see ( x , katherine ) ) <eos>
everyone knows winnifred <eos>	all x . ( person ( x ) -> know ( x , winnifred ) ) <eos>	all x . ( person ( x ) -> like ( x , winnifred ) ) <eos>
every hoplite dislikes victor <eos>	all x . ( hoplite ( x ) -> dislike ( x , victor ) ) <eos>	all x . ( hoplite ( x ) -> notice ( x , victor ) ) <eos>
every turtle meets himself <eos>	all x . ( turtle ( x ) -> meet ( x , x ) ) <eos>	all x . ( turtle ( x ) -> notice ( x , x ) ) <eos>
every actor notices quinn <eos>	all x . ( actor ( x ) -> notice ( x , quinn ) ) <eos>	all x . ( turtle ( x ) -> meet ( x , quinn ) ) <eos>
rachael dislikes isla <eos>	dislike ( rachael , isla ) <eos>	dislike ( rachael , isla ) <eos>
patricia likes herself <eos>	like ( patricia , patricia ) <eos>	like ( patricia , patricia ) <eos>
neha knows francis <eos>	know ( neha , francis ) <eos>	know ( neha , francis ) <eos>
patricia notices henry <eos>	notice ( patricia , henry ) <eos>	notice ( patricia , henry ) <eos>
katherine meets eliza <eos>	meet ( katherine , eliza ) <eos>	meet ( katherine , eliza ) <eos>
margaret dislikes henry <eos>	dislike ( margaret , henry ) <eos>	dislike ( margaret , henry ) <eos>
quinn throws daniel <eos>	throw ( quinn , daniel ) <eos>	throw ( quinn , daniel ) <eos>
francis meets francis <eos>	meet ( francis , francis ) <eos>	meet ( francis , francis ) <eos>
oswald notices lewis <eos>	notice ( oswald , lewis ) <eos>	notice ( oswald , lewis ) <eos>
samuel dislikes lewis <eos>	dislike ( samuel , lewis ) <eos>	dislike ( samuel , lewis ) <eos>
claire notices samuel <eos>	notice ( claire , samuel ) <eos>	notice ( claire , samuel ) <eos>
alice likes zelda <eos>	like ( alice , zelda ) <eos>	like ( alice , zelda ) <eos>
patricia likes xerxes <eos>	like ( patricia , xerxes ) <eos>	like ( patricia , xerxes ) <eos>
xerxes sees katherine <eos>	see ( xerxes , katherine ) <eos>	see ( xerxes , katherine ) <eos>
winnifred meets yvette <eos>	meet ( winnifred , yvettte ) <eos>	meet ( winnifred , yvettte ) <eos>
alice meets winnifred <eos>	meet ( alice , winnifred ) <eos>	meet ( alice , winnifred ) <eos>
ursula sees yvette <eos>	see ( ursula , yvettte ) <eos>	see ( ursula , yvettte ) <eos>
bob likes zelda <eos>	like ( bob , zelda ) <eos>	like ( bob , zelda ) <eos>
tracy dislikes isla <eos>	dislike ( tracy , isla ) <eos>	dislike ( tracy , isla ) <eos>
daniel likes zelda <eos>	like ( daniel , zelda ) <eos>	like ( daniel , zelda ) <eos>
every dog knows patricia <eos>	all x . ( dog ( x ) -> know ( x , patricia ) ) <eos>	all x . ( dog ( x ) -> throw ( x , patricia ) ) <eos>
every hoplite dislikes patricia <eos>	all x . ( hoplite ( x ) -> dislike ( x , patricia ) ) <eos>	all x . ( hoplite ( x ) -> throw ( x , patricia ) ) <eos>
every hoplite notices yvette <eos>	all x . ( hoplite ( x ) -> notice ( x , yvettte ) ) <eos>	all x . ( hoplite ( x ) -> meet ( x , yvettte ) ) <eos>
every turtle likes victor <eos>	all x . ( turtle ( x ) -> like ( x , victor ) ) <eos>	all x . ( turtle ( x ) -> notice ( x , victor ) ) <eos>
every turtle meets xerxes <eos>	all x . ( turtle ( x ) -> meet ( x , xerxes ) ) <eos>	all x . ( turtle ( x ) -> notice ( x , xerxes ) ) <eos>
henry sees zelda <eos>	see ( henry , zelda ) <eos>	see ( henry , zelda ) <eos>
daniel likes xerxes <eos>	like ( daniel , xerxes ) <eos>	like ( daniel , xerxes ) <eos>
isla dislikes yvette <eos>	dislike ( isla , yvettte ) <eos>	dislike ( isla , yvettte ) <eos>
xerxes dislikes lewis <eos>	dislike ( xerxes , lewis ) <eos>	dislike ( xerxes , lewis ) <eos>
isla sees lewis <eos>	see ( isla , lewis ) <eos>	see ( isla , lewis ) <eos>
alice likes lewis <eos>	like ( alice , lewis ) <eos>	like ( alice , lewis ) <eos>
grace meets francis <eos>	meet ( grace , francis ) <eos>	meet ( grace , francis ) <eos>
isla likes oswald <eos>	like ( isla , oswald ) <eos>	like ( isla , oswald ) <eos>
winnifred dislikes zelda <eos>	dislike ( winnifred , zelda ) <eos>	dislike ( winnifred , zelda ) <eos>
tracy sees francis <eos>	see ( tracy , francis ) <eos>	see ( tracy , francis ) <eos>
daniel dislikes xerxes <eos>	dislike ( daniel , xerxes ) <eos>	dislike ( daniel , xerxes ) <eos>
zelda sees oswald <eos>	see ( zelda , oswald ) <eos>	see ( zelda , oswald ) <eos>
ursula throws katherine <eos>	throw ( ursula , katherine ) <eos>	throw ( ursula , katherine ) <eos>
yvette meets xerxes <eos>	meet ( yvettte , xerxes ) <eos>	meet ( yvettte , xerxes ) <eos>
margaret likes rachael <eos>	like ( margaret , rachael ) <eos>	like ( margaret , rachael ) <eos>
every bear knows bob <eos>	all x . ( bear ( x ) -> know ( x , bob ) ) <eos>	all x . ( bear ( x ) -> see ( x , bob ) ) <eos>
every turtle knows winnifred <eos>	all x . ( turtle ( x ) -> know ( x , winnifred ) ) <eos>	all x . ( turtle ( x ) -> see ( x , winnifred ) ) <eos>
every dog sees zelda <eos>	all x . ( dog ( x ) -> see ( x , zelda ) ) <eos>	all x . ( dog ( x ) -> notice ( x , zelda ) ) <eos>
every person throws grace <eos>	all x . ( person ( x ) -> throw ( x , grace ) ) <eos>	all x . ( person ( x ) -> see ( x , grace ) ) <eos>
every person likes henry <eos>	all x . ( person ( x ) -> like ( x , henry ) ) <eos>	all x . ( person ( x ) -> notice ( x , henry ) ) <eos>
every actor sees katherine <eos>	all x . ( actor ( x ) -> see ( x , katherine ) ) <eos>	all x . ( turtle ( x ) -> meet ( x , katherine ) ) <eos>
every bear likes neha <eos>	all x . ( bear ( x ) -> like ( x , neha ) ) <eos>	all x . ( bear ( x ) -> throw ( x , neha ) ) <eos>
every bear dislikes oswald <eos>	all x . ( bear ( x ) -> dislike ( x , oswald ) ) <eos>	all x . ( bear ( x ) -> see ( x , oswald ) ) <eos>
everyone throws daniel <eos>	all x . ( person ( x ) -> throw ( x , daniel ) ) <eos>	all x . ( person ( x ) -> see ( x , daniel ) ) <eos>
every dog sees isla <eos>	all x . ( dog ( x ) -> see ( x , isla ) ) <eos>	all x . ( prion ( x ) -> meet ( x , isla ) ) <eos>
katherine notices xerxes <eos>	notice ( katherine , xerxes ) <eos>	notice ( katherine , xerxes ) <eos>
xerxes likes ursula <eos>	like ( xerxes , ursula ) <eos>	like ( xerxes , ursula ) <eos>
patricia likes john <eos>	like ( patricia , john ) <eos>	like ( patricia , john ) <eos>
eliza throws samuel <eos>	throw ( eliza , samuel ) <eos>	throw ( eliza , samuel ) <eos>
alice dislikes samuel <eos>	dislike ( alice , samuel ) <eos>	dislike ( alice , samuel ) <eos>
every dog throws bob <eos>	all x . ( dog ( x ) -> throw ( x , bob ) ) <eos>	all x . ( dog ( x ) -> see ( x , bob ) ) <eos>
every prion likes patricia <eos>	all x . ( prion ( x ) -> like ( x , patricia ) ) <eos>	all x . ( prion ( x ) -> throw ( x , patricia ) ) <eos>
every dog throws grace <eos>	all x . ( dog ( x ) -> throw ( x , grace ) ) <eos>	all x . ( dog ( x ) -> meet ( x , grace ) ) <eos>
every prion dislikes lewis <eos>	all x . ( prion ( x ) -> dislike ( x , lewis ) ) <eos>	all x . ( prion ( x ) -> throw ( x , lewis ) ) <eos>
every hoplite knows daniel <eos>	all x . ( hoplite ( x ) -> know ( x , daniel ) ) <eos>	all x . ( hoplite ( x ) -> notice ( x , daniel ) ) <eos>
every dog knows daniel <eos>	all x . ( dog ( x ) -> know ( x , daniel ) ) <eos>	all x . ( dog ( x ) -> notice ( x , daniel ) ) <eos>
every turtle knows daniel <eos>	all x . ( turtle ( x ) -> know ( x , daniel ) ) <eos>	all x . ( turtle ( x ) -> notice ( x , daniel ) ) <eos>
every condor notices alice <eos>	all x . ( condor ( x ) -> notice ( x , alice ) ) <eos>	all x . ( bear ( x ) -> see ( x , alice ) ) <eos>
every turtle notices himself <eos>	all x . ( turtle ( x ) -> notice ( x , x ) ) <eos>	all x . ( turtle ( x ) -> see ( x , x ) ) <eos>
every hoplite meets lewis <eos>	all x . ( hoplite ( x ) -> meet ( x , lewis ) ) <eos>	all x . ( hoplite ( x ) -> throw ( x , lewis ) ) <eos>
every bear likes rachael <eos>	all x . ( bear ( x ) -> like ( x , rachael ) ) <eos>	all x . ( bear ( x ) -> meet ( x , rachael ) ) <eos>
every condor meets victor <eos>	all x . ( condor ( x ) -> meet ( x , victor ) ) <eos>	all x . ( bear ( x ) -> notice ( x , victor ) ) <eos>
everyone sees neha <eos>	all x . ( person ( x ) -> see ( x , neha ) ) <eos>	all x . ( person ( x ) -> throw ( x , neha ) ) <eos>
every prion meets yvette <eos>	all x . ( prion ( x ) -> meet ( x , yvettte ) ) <eos>	all x . ( prion ( x ) -> meet ( x , yvettte ) ) <eos>
every bear knows alice <eos>	all x . ( bear ( x ) -> know ( x , alice ) ) <eos>	all x . ( bear ( x ) -> meet ( x , alice ) ) <eos>
neha throws daniel <eos>	throw ( neha , daniel ) <eos>	throw ( neha , daniel ) <eos>
katherine notices tracy <eos>	notice ( katherine , tracy ) <eos>	notice ( katherine , tracy ) <eos>
katherine dislikes alice <eos>	dislike ( katherine , alice ) <eos>	dislike ( katherine , alice ) <eos>
rachael dislikes yvette <eos>	dislike ( rachael , yvettte ) <eos>	dislike ( rachael , yvettte ) <eos>
lewis knows katherine <eos>	know ( lewis , katherine ) <eos>	know ( lewis , katherine ) <eos>
francis throws francis <eos>	throw ( francis , francis ) <eos>	throw ( francis , francis ) <eos>
winnifred likes grace <eos>	like ( winnifred , grace ) <eos>	like ( winnifred , grace ) <eos>
victor dislikes ursula <eos>	dislike ( victor , ursula ) <eos>	dislike ( victor , ursula ) <eos>
bob knows bob <eos>	know ( bob , bob ) <eos>	know ( bob , bob ) <eos>
francis sees neha <eos>	see ( francis , neha ) <eos>	see ( francis , neha ) <eos>
every person throws herself <eos>	all x . ( person ( x ) -> throw ( x , x ) ) <eos>	all x . ( person ( x ) -> see ( x , x ) ) <eos>
every hoplite throws winnifred <eos>	all x . ( hoplite ( x ) -> throw ( x , winnifred ) ) <eos>	all x . ( hoplite ( x ) -> see ( x , winnifred ) ) <eos>
every prion dislikes isla <eos>	all x . ( prion ( x ) -> dislike ( x , isla ) ) <eos>	all x . ( prion ( x ) -> throw ( x , isla ) ) <eos>
everyone throws xerxes <eos>	all x . ( person ( x ) -> throw ( x , xerxes ) ) <eos>	all x . ( person ( x ) -> notice ( x , xerxes ) ) <eos>
every bear sees winnifred <eos>	all x . ( bear ( x ) -> see ( x , winnifred ) ) <eos>	all x . ( bear ( x ) -> like ( x , winnifred ) ) <eos>
patricia throws grace <eos>	throw ( patricia , grace ) <eos>	throw ( patricia , grace ) <eos>
rachael sees lewis <eos>	see ( rachael , lewis ) <eos>	see ( rachael , lewis ) <eos>
francis likes yvette <eos>	like ( francis , yvettte ) <eos>	like ( francis , yvettte ) <eos>
lewis dislikes lewis <eos>	dislike ( lewis , lewis ) <eos>	dislike ( lewis , lewis ) <eos>
alice throws francis <eos>	throw ( alice , francis ) <eos>	throw ( alice , francis ) <eos>
claire sees tracy <eos>	see ( claire , tracy ) <eos>	see ( claire , tracy ) <eos>
ursula knows francis <eos>	know ( ursula , francis ) <eos>	know ( ursula , francis ) <eos>
lewis knows margaret <eos>	know ( lewis , margaret ) <eos>	know ( lewis , margaret ) <eos>
quinn throws john <eos>	throw ( quinn , john ) <eos>	throw ( quinn , john ) <eos>
daniel notices katherine <eos>	notice ( daniel , katherine ) <eos>	notice ( daniel , katherine ) <eos>
claire notices alice <eos>	notice ( claire , alice ) <eos>	notice ( claire , alice ) <eos>
quinn throws xerxes <eos>	throw ( quinn , xerxes ) <eos>	throw ( quinn , xerxes ) <eos>
oswald likes francis <eos>	like ( oswald , francis ) <eos>	like ( oswald , francis ) <eos>
rachael meets yvette <eos>	meet ( rachael , yvettte ) <eos>	meet ( rachael , yvettte ) <eos>
bob notices daniel <eos>	notice ( bob , daniel ) <eos>	notice ( bob , daniel ) <eos>
isla dislikes yvette <eos>	dislike ( isla , yvettte ) <eos>	dislike ( isla , yvettte ) <eos>
lewis dislikes himself <eos>	dislike ( lewis , lewis ) <eos>	dislike ( lewis , lewis ) <eos>
francis dislikes henry <eos>	dislike ( francis , henry ) <eos>	dislike ( francis , henry ) <eos>
alice likes lewis <eos>	like ( alice , lewis ) <eos>	like ( alice , lewis ) <eos>
tracy meets bob <eos>	meet ( tracy , bob ) <eos>	meet ( tracy , bob ) <eos>
yvette knows henry <eos>	know ( yvettte , henry ) <eos>	know ( yvettte , henry ) <eos>
rachael throws samuel <eos>	throw ( rachael , samuel ) <eos>	throw ( rachael , samuel ) <eos>
neha meets xerxes <eos>	meet ( neha , xerxes ) <eos>	meet ( neha , xerxes ) <eos>
rachael knows tracy <eos>	know ( rachael , tracy ) <eos>	know ( rachael , tracy ) <eos>
victor runs <eos>	run ( victor ) <eos>	slumber ( victor ) <eos>
lewis sees zelda <eos>	see ( lewis , zelda ) <eos>	see ( lewis , zelda ) <eos>
rachael knows ursula <eos>	know ( rachael , ursula ) <eos>	know ( rachael , ursula ) <eos>
daniel sees isla <eos>	see ( daniel , isla ) <eos>	see ( daniel , isla ) <eos>
john sees victor <eos>	see ( john , victor ) <eos>	see ( john , victor ) <eos>
oswald knows daniel <eos>	know ( oswald , daniel ) <eos>	know ( oswald , daniel ) <eos>
claire sees grace <eos>	see ( claire , grace ) <eos>	see ( claire , grace ) <eos>
samuel throws victor <eos>	throw ( samuel , victor ) <eos>	throw ( samuel , victor ) <eos>
oswald notices katherine <eos>	notice ( oswald , katherine ) <eos>	notice ( oswald , katherine ) <eos>
alice notices alice <eos>	notice ( alice , alice ) <eos>	notice ( alice , alice ) <eos>
eliza sees xerxes <eos>	see ( eliza , xerxes ) <eos>	see ( eliza , xerxes ) <eos>
winnifred sees alice <eos>	see ( winnifred , alice ) <eos>	see ( winnifred , alice ) <eos>
daniel throws grace <eos>	throw ( daniel , grace ) <eos>	throw ( daniel , grace ) <eos>
alice throws isla <eos>	throw ( alice , isla ) <eos>	throw ( alice , isla ) <eos>
bob notices claire <eos>	notice ( bob , claire ) <eos>	notice ( bob , claire ) <eos>
bob meets zelda <eos>	meet ( bob , zelda ) <eos>	meet ( bob , zelda ) <eos>
every dog throws samuel <eos>	all x . ( dog ( x ) -> throw ( x , samuel ) ) <eos>	all x . ( dog ( x ) -> see ( x , samuel ) ) <eos>
every actor knows patricia <eos>	all x . ( actor ( x ) -> know ( x , patricia ) ) <eos>	all x . ( actor ( x ) -> throw ( x , patricia ) ) <eos>
every actor likes claire <eos>	all x . ( actor ( x ) -> like ( x , claire ) ) <eos>	all x . ( actor ( x ) -> throw ( x , claire ) ) <eos>
every person meets oswald <eos>	all x . ( person ( x ) -> meet ( x , oswald ) ) <eos>	all x . ( person ( x ) -> see ( x , oswald ) ) <eos>
everyone throws victor <eos>	all x . ( person ( x ) -> throw ( x , victor ) ) <eos>	all x . ( person ( x ) -> notice ( x , victor ) ) <eos>
ursula sees margaret <eos>	see ( ursula , margaret ) <eos>	see ( ursula , margaret ) <eos>
katherine meets alice <eos>	meet ( katherine , alice ) <eos>	meet ( katherine , alice ) <eos>
rachael sees tracy <eos>	see ( rachael , tracy ) <eos>	see ( rachael , tracy ) <eos>
margaret likes daniel <eos>	like ( margaret , daniel ) <eos>	like ( margaret , daniel ) <eos>
alice meets grace <eos>	meet ( alice , grace ) <eos>	meet ( alice , grace ) <eos>
someone meets john <eos>	exists x . ( person ( x ) & meet ( x , john ) ) <eos>	exists x . ( person ( x ) & notice ( x , john ) ) <eos>
every actor sees henry <eos>	all x . ( actor ( x ) -> see ( x , henry ) ) <eos>	all x . ( turtle ( x ) -> notice ( x , henry ) ) <eos>
every prion likes neha <eos>	all x . ( prion ( x ) -> like ( x , neha ) ) <eos>	all x . ( dog ( x ) -> throw ( x , neha ) ) <eos>
every turtle notices zelda <eos>	all x . ( turtle ( x ) -> notice ( x , zelda ) ) <eos>	all x . ( turtle ( x ) -> notice ( x , zelda ) ) <eos>
every turtle notices john <eos>	all x . ( turtle ( x ) -> notice ( x , john ) ) <eos>	all x . ( turtle ( x ) -> meet ( x , john ) ) <eos>
quinn meets zelda <eos>	meet ( quinn , zelda ) <eos>	meet ( quinn , zelda ) <eos>
daniel meets quinn <eos>	meet ( daniel , quinn ) <eos>	meet ( daniel , quinn ) <eos>
xerxes dislikes xerxes <eos>	dislike ( xerxes , xerxes ) <eos>	dislike ( xerxes , xerxes ) <eos>
ursula sees francis <eos>	see ( ursula , francis ) <eos>	see ( ursula , francis ) <eos>
francis dislikes neha <eos>	dislike ( francis , neha ) <eos>	dislike ( francis , neha ) <eos>
bob notices alice <eos>	notice ( bob , alice ) <eos>	notice ( bob , alice ) <eos>
eliza sees claire <eos>	see ( eliza , claire ) <eos>	see ( eliza , claire ) <eos>
zelda sees neha <eos>	see ( zelda , neha ) <eos>	see ( zelda , neha ) <eos>
zelda likes isla <eos>	like ( zelda , isla ) <eos>	like ( zelda , isla ) <eos>
isla throws rachael <eos>	throw ( isla , rachael ) <eos>	throw ( isla , rachael ) <eos>
grace throws margaret <eos>	throw ( grace , margaret ) <eos>	throw ( grace , margaret ) <eos>
francis throws samuel <eos>	throw ( francis , samuel ) <eos>	throw ( francis , samuel ) <eos>
lewis knows neha <eos>	know ( lewis , neha ) <eos>	know ( lewis , neha ) <eos>
neha notices katherine <eos>	notice ( neha , katherine ) <eos>	notice ( neha , katherine ) <eos>
samuel notices zelda <eos>	notice ( samuel , zelda ) <eos>	notice ( samuel , zelda ) <eos>
xerxes dances <eos>	dance ( xerxes ) <eos>	dance ( xerxes ) <eos>
quinn runs <eos>	run ( quinn ) <eos>	run ( quinn ) <eos>
oswald sings <eos>	sing ( oswald ) <eos>	sing ( oswald ) <eos>
winnifred flies <eos>	fly ( winnifred ) <eos>	fly ( winnifred ) <eos>
ursula runs <eos>	run ( ursula ) <eos>	run ( ursula ) <eos>
every condor meets neha <eos>	all x . ( condor ( x ) -> meet ( x , neha ) ) <eos>	all x . ( bear ( x ) -> throw ( x , neha ) ) <eos>
every bear knows lewis <eos>	all x . ( bear ( x ) -> know ( x , lewis ) ) <eos>	all x . ( condor ( x ) -> throw ( x , lewis ) ) <eos>
every prion likes lewis <eos>	all x . ( prion ( x ) -> like ( x , lewis ) ) <eos>	all x . ( prion ( x ) -> throw ( x , lewis ) ) <eos>
everyone throws tracy <eos>	all x . ( person ( x ) -> throw ( x , tracy ) ) <eos>	all x . ( person ( x ) -> see ( x , tracy ) ) <eos>
every dog likes victor <eos>	all x . ( dog ( x ) -> like ( x , victor ) ) <eos>	all x . ( prion ( x ) -> notice ( x , victor ) ) <eos>
grace likes claire <eos>	like ( grace , claire ) <eos>	like ( grace , claire ) <eos>
patricia throws neha <eos>	throw ( patricia , neha ) <eos>	throw ( patricia , neha ) <eos>
francis sees rachael <eos>	see ( francis , rachael ) <eos>	see ( francis , rachael ) <eos>
claire throws alice <eos>	throw ( claire , alice ) <eos>	throw ( claire , alice ) <eos>
tracy throws eliza <eos>	throw ( tracy , eliza ) <eos>	throw ( tracy , eliza ) <eos>
yvette meets henry <eos>	meet ( yvettte , henry ) <eos>	meet ( yvettte , henry ) <eos>
isla sees winnifred <eos>	see ( isla , winnifred ) <eos>	see ( isla , winnifred ) <eos>
rachael likes alice <eos>	like ( rachael , alice ) <eos>	like ( rachael , alice ) <eos>
patricia throws francis <eos>	throw ( patricia , francis ) <eos>	throw ( patricia , francis ) <eos>
tracy throws rachael <eos>	throw ( tracy , rachael ) <eos>	throw ( tracy , rachael ) <eos>
grace throws rachael <eos>	throw ( grace , rachael ) <eos>	throw ( grace , rachael ) <eos>
margaret dislikes francis <eos>	dislike ( margaret , francis ) <eos>	dislike ( margaret , francis ) <eos>
grace throws rachael <eos>	throw ( grace , rachael ) <eos>	throw ( grace , rachael ) <eos>
yvette sees isla <eos>	see ( yvettte , isla ) <eos>	see ( yvettte , isla ) <eos>
tracy dislikes herself <eos>	dislike ( tracy , tracy ) <eos>	dislike ( tracy , tracy ) <eos>
tracy sees yvette <eos>	see ( tracy , yvettte ) <eos>	see ( tracy , yvettte ) <eos>
winnifred likes yvette <eos>	like ( winnifred , yvettte ) <eos>	like ( winnifred , yvettte ) <eos>
margaret dislikes john <eos>	dislike ( margaret , john ) <eos>	dislike ( margaret , john ) <eos>
zelda likes eliza <eos>	like ( zelda , eliza ) <eos>	like ( zelda , eliza ) <eos>
victor notices claire <eos>	notice ( victor , claire ) <eos>	notice ( victor , claire ) <eos>
xerxes sees zelda <eos>	see ( xerxes , zelda ) <eos>	see ( xerxes , zelda ) <eos>
zelda sees lewis <eos>	see ( zelda , lewis ) <eos>	see ( zelda , lewis ) <eos>
john dislikes katherine <eos>	dislike ( john , katherine ) <eos>	dislike ( john , katherine ) <eos>
john sees henry <eos>	see ( john , henry ) <eos>	see ( john , henry ) <eos>
john meets tracy <eos>	meet ( john , tracy ) <eos>	meet ( john , tracy ) <eos>
henry meets francis <eos>	meet ( henry , francis ) <eos>	meet ( henry , francis ) <eos>
grace likes grace <eos>	like ( grace , grace ) <eos>	like ( grace , grace ) <eos>
rachael meets claire <eos>	meet ( rachael , claire ) <eos>	meet ( rachael , claire ) <eos>
tracy likes claire <eos>	like ( tracy , claire ) <eos>	like ( tracy , claire ) <eos>
eliza meets patricia <eos>	meet ( eliza , patricia ) <eos>	meet ( eliza , patricia ) <eos>
isla likes margaret <eos>	like ( isla , margaret ) <eos>	like ( isla , margaret ) <eos>
zelda sees zelda <eos>	see ( zelda , zelda ) <eos>	see ( zelda , zelda ) <eos>
samuel meets victor <eos>	meet ( samuel , victor ) <eos>	meet ( samuel , victor ) <eos>
rachael dislikes alice <eos>	dislike ( rachael , alice ) <eos>	dislike ( rachael , alice ) <eos>
daniel likes tracy <eos>	like ( daniel , tracy ) <eos>	like ( daniel , tracy ) <eos>
every prion sees henry <eos>	all x . ( prion ( x ) -> see ( x , henry ) ) <eos>	all x . ( dog ( x ) -> meet ( x , henry ) ) <eos>
every bear notices daniel <eos>	all x . ( bear ( x ) -> notice ( x , daniel ) ) <eos>	all x . ( condor ( x ) -> notice ( x , daniel ) ) <eos>
every actor notices katherine <eos>	all x . ( actor ( x ) -> notice ( x , katherine ) ) <eos>	all x . ( actor ( x ) -> see ( x , katherine ) ) <eos>
every prion knows margaret <eos>	all x . ( prion ( x ) -> know ( x , margaret ) ) <eos>	all x . ( dog ( x ) -> meet ( x , margaret ) ) <eos>
every condor meets patricia <eos>	all x . ( condor ( x ) -> meet ( x , patricia ) ) <eos>	all x . ( condor ( x ) -> throw ( x , patricia ) ) <eos>
quinn dislikes tracy <eos>	dislike ( quinn , tracy ) <eos>	dislike ( quinn , tracy ) <eos>
neha throws neha <eos>	throw ( neha , neha ) <eos>	throw ( neha , neha ) <eos>
eliza sees katherine <eos>	see ( eliza , katherine ) <eos>	see ( eliza , katherine ) <eos>
grace notices quinn <eos>	notice ( grace , quinn ) <eos>	notice ( grace , quinn ) <eos>
alice dislikes tracy <eos>	dislike ( alice , tracy ) <eos>	dislike ( alice , tracy ) <eos>
oswald dislikes claire <eos>	dislike ( oswald , claire ) <eos>	dislike ( oswald , claire ) <eos>
bob likes john <eos>	like ( bob , john ) <eos>	like ( bob , john ) <eos>
bob likes yvette <eos>	like ( bob , yvettte ) <eos>	like ( bob , yvettte ) <eos>
oswald meets ursula <eos>	meet ( oswald , ursula ) <eos>	meet ( oswald , ursula ) <eos>
tracy knows tracy <eos>	know ( tracy , tracy ) <eos>	know ( tracy , tracy ) <eos>
xerxes notices zelda <eos>	notice ( xerxes , zelda ) <eos>	notice ( xerxes , zelda ) <eos>
margaret meets ursula <eos>	meet ( margaret , ursula ) <eos>	meet ( margaret , ursula ) <eos>
yvette notices grace <eos>	notice ( yvettte , grace ) <eos>	notice ( yvettte , grace ) <eos>
henry throws bob <eos>	throw ( henry , bob ) <eos>	throw ( henry , bob ) <eos>
ursula dislikes rachael <eos>	dislike ( ursula , rachael ) <eos>	dislike ( ursula , rachael ) <eos>
henry throws isla <eos>	throw ( henry , isla ) <eos>	throw ( henry , isla ) <eos>
eliza throws tracy <eos>	throw ( eliza , tracy ) <eos>	throw ( eliza , tracy ) <eos>
rachael notices victor <eos>	notice ( rachael , victor ) <eos>	notice ( rachael , victor ) <eos>
winnifred notices eliza <eos>	notice ( winnifred , eliza ) <eos>	notice ( winnifred , eliza ) <eos>
francis dislikes grace <eos>	dislike ( francis , grace ) <eos>	dislike ( francis , grace ) <eos>
every hoplite throws samuel <eos>	all x . ( hoplite ( x ) -> throw ( x , samuel ) ) <eos>	all x . ( hoplite ( x ) -> see ( x , samuel ) ) <eos>
someone sees victor <eos>	exists x . ( person ( x ) & see ( x , victor ) ) <eos>	exists x . ( person ( x ) & see ( x , victor ) ) <eos>
every dog throws xerxes <eos>	all x . ( dog ( x ) -> throw ( x , xerxes ) ) <eos>	all x . ( dog ( x ) -> notice ( x , xerxes ) ) <eos>
someone meets rachael <eos>	exists x . ( person ( x ) & meet ( x , rachael ) ) <eos>	exists x . ( person ( x ) & like ( x , rachael ) ) <eos>
every dog likes claire <eos>	all x . ( dog ( x ) -> like ( x , claire ) ) <eos>	all x . ( dog ( x ) -> see ( x , claire ) ) <eos>
patricia notices tracy <eos>	notice ( patricia , tracy ) <eos>	notice ( patricia , tracy ) <eos>
john likes quinn <eos>	like ( john , quinn ) <eos>	like ( john , quinn ) <eos>
victor throws grace <eos>	throw ( victor , grace ) <eos>	throw ( victor , grace ) <eos>
xerxes knows ursula <eos>	know ( xerxes , ursula ) <eos>	know ( xerxes , ursula ) <eos>
patricia sees francis <eos>	see ( patricia , francis ) <eos>	see ( patricia , francis ) <eos>
lewis sees francis <eos>	see ( lewis , francis ) <eos>	see ( lewis , francis ) <eos>
daniel meets lewis <eos>	meet ( daniel , lewis ) <eos>	meet ( daniel , lewis ) <eos>
francis likes ursula <eos>	like ( francis , ursula ) <eos>	like ( francis , ursula ) <eos>
francis throws winnifred <eos>	throw ( francis , winnifred ) <eos>	throw ( francis , winnifred ) <eos>
winnifred throws francis <eos>	throw ( winnifred , francis ) <eos>	throw ( winnifred , francis ) <eos>
someone dislikes claire <eos>	exists x . ( person ( x ) & dislike ( x , claire ) ) <eos>	all x . ( actor ( x ) -> see ( x , ursula ) ) <eos>
every hoplite eats <eos>	all x . ( hoplite ( x ) -> eat ( x ) ) <eos>	all x . ( turtle ( x ) -> walk ( x ) ) <eos>
every bear runs <eos>	all x . ( bear ( x ) -> run ( x ) ) <eos>	all x . ( condor ( x ) -> see ( x ) ) <eos>
francis likes katherine <eos>	like ( francis , katherine ) <eos>	like ( francis , katherine ) <eos>
neha sees winnifred <eos>	see ( neha , winnifred ) <eos>	see ( neha , winnifred ) <eos>
tracy dislikes henry <eos>	dislike ( tracy , henry ) <eos>	dislike ( tracy , henry ) <eos>
yvette notices patricia <eos>	notice ( yvettte , patricia ) <eos>	notice ( yvettte , patricia ) <eos>
bob dislikes samuel <eos>	dislike ( bob , samuel ) <eos>	dislike ( bob , samuel ) <eos>
claire sees patricia <eos>	see ( claire , patricia ) <eos>	see ( claire , patricia ) <eos>
john meets oswald <eos>	meet ( john , oswald ) <eos>	meet ( john , oswald ) <eos>
every actor sees daniel <eos>	all x . ( actor ( x ) -> see ( x , daniel ) ) <eos>	all x . ( actor ( x ) -> notice ( x , daniel ) ) <eos>
every condor notices yvette <eos>	all x . ( condor ( x ) -> notice ( x , yvettte ) ) <eos>	all x . ( condor ( x ) -> throw ( x , yvettte ) ) <eos>
every actor throws neha <eos>	all x . ( actor ( x ) -> throw ( x , neha ) ) <eos>	all x . ( turtle ( x ) -> throw ( x , neha ) ) <eos>
every prion dislikes quinn <eos>	all x . ( prion ( x ) -> dislike ( x , quinn ) ) <eos>	all x . ( dog ( x ) -> meet ( x , quinn ) ) <eos>
every condor meets winnifred <eos>	all x . ( condor ( x ) -> meet ( x , winnifred ) ) <eos>	all x . ( bear ( x ) -> like ( x , winnifred ) ) <eos>
someone sees francis <eos>	exists x . ( person ( x ) & see ( x , francis ) ) <eos>	exists x . ( person ( x ) & see ( x , francis ) ) <eos>
every turtle meets john <eos>	all x . ( turtle ( x ) -> meet ( x , john ) ) <eos>	all x . ( turtle ( x ) -> see ( x , john ) ) <eos>
someone notices francis <eos>	exists x . ( person ( x ) & notice ( x , francis ) ) <eos>	exists x . ( person ( x ) & like ( x , francis ) ) <eos>
every bear sees herself <eos>	all x . ( bear ( x ) -> see ( x , x ) ) <eos>	all x . ( bear ( x ) -> see ( x , x ) ) <eos>
every condor knows herself <eos>	all x . ( condor ( x ) -> know ( x , x ) ) <eos>	all x . ( condor ( x ) -> see ( x , x ) ) <eos>
neha dislikes margaret <eos>	dislike ( neha , margaret ) <eos>	dislike ( neha , margaret ) <eos>
daniel dislikes isla <eos>	dislike ( daniel , isla ) <eos>	dislike ( daniel , isla ) <eos>
zelda knows katherine <eos>	know ( zelda , katherine ) <eos>	know ( zelda , katherine ) <eos>
tracy throws neha <eos>	throw ( tracy , neha ) <eos>	throw ( tracy , neha ) <eos>
victor notices rachael <eos>	notice ( victor , rachael ) <eos>	notice ( victor , rachael ) <eos>
katherine notices winnifred <eos>	notice ( katherine , winnifred ) <eos>	notice ( katherine , winnifred ) <eos>
neha notices daniel <eos>	notice ( neha , daniel ) <eos>	notice ( neha , daniel ) <eos>
lewis dislikes patricia <eos>	dislike ( lewis , patricia ) <eos>	dislike ( lewis , patricia ) <eos>
henry likes samuel <eos>	like ( henry , samuel ) <eos>	like ( henry , samuel ) <eos>
grace notices patricia <eos>	notice ( grace , patricia ) <eos>	notice ( grace , patricia ) <eos>
everyone notices alice <eos>	all x . ( person ( x ) -> notice ( x , alice ) ) <eos>	all x . ( person ( x ) -> like ( x , alice ) ) <eos>
every turtle throws tracy <eos>	all x . ( turtle ( x ) -> throw ( x , tracy ) ) <eos>	all x . ( turtle ( x ) -> notice ( x , tracy ) ) <eos>
every turtle meets oswald <eos>	all x . ( turtle ( x ) -> meet ( x , oswald ) ) <eos>	all x . ( turtle ( x ) -> notice ( x , oswald ) ) <eos>
every person meets neha <eos>	all x . ( person ( x ) -> meet ( x , neha ) ) <eos>	all x . ( person ( x ) -> throw ( x , neha ) ) <eos>
every bear dislikes tracy <eos>	all x . ( bear ( x ) -> dislike ( x , tracy ) ) <eos>	all x . ( condor ( x ) -> see ( x , tracy ) ) <eos>
henry sees quinn <eos>	see ( henry , quinn ) <eos>	see ( henry , quinn ) <eos>
tracy meets ursula <eos>	meet ( tracy , ursula ) <eos>	meet ( tracy , ursula ) <eos>
patricia knows patricia <eos>	know ( patricia , patricia ) <eos>	know ( patricia , patricia ) <eos>
rachael meets daniel <eos>	meet ( rachael , daniel ) <eos>	meet ( rachael , daniel ) <eos>
rachael sees yvette <eos>	see ( rachael , yvettte ) <eos>	see ( rachael , yvettte ) <eos>
grace knows claire <eos>	know ( grace , claire ) <eos>	know ( grace , claire ) <eos>
bob dislikes francis <eos>	dislike ( bob , francis ) <eos>	dislike ( bob , francis ) <eos>
neha meets ursula <eos>	meet ( neha , ursula ) <eos>	meet ( neha , ursula ) <eos>
xerxes meets daniel <eos>	meet ( xerxes , daniel ) <eos>	meet ( xerxes , daniel ) <eos>
patricia knows neha <eos>	know ( patricia , neha ) <eos>	know ( patricia , neha ) <eos>
francis sees margaret <eos>	see ( francis , margaret ) <eos>	see ( francis , margaret ) <eos>
quinn likes alice <eos>	like ( quinn , alice ) <eos>	like ( quinn , alice ) <eos>
margaret sees eliza <eos>	see ( margaret , eliza ) <eos>	see ( margaret , eliza ) <eos>
john throws oswald <eos>	throw ( john , oswald ) <eos>	throw ( john , oswald ) <eos>
quinn meets lewis <eos>	meet ( quinn , lewis ) <eos>	meet ( quinn , lewis ) <eos>
alice dislikes quinn <eos>	dislike ( alice , quinn ) <eos>	dislike ( alice , quinn ) <eos>
patricia dislikes samuel <eos>	dislike ( patricia , samuel ) <eos>	dislike ( patricia , samuel ) <eos>
tracy sees isla <eos>	see ( tracy , isla ) <eos>	see ( tracy , isla ) <eos>
margaret sees zelda <eos>	see ( margaret , zelda ) <eos>	see ( margaret , zelda ) <eos>
yvette sees quinn <eos>	see ( yvettte , quinn ) <eos>	see ( yvettte , quinn ) <eos>
alice knows daniel <eos>	know ( alice , daniel ) <eos>	know ( alice , daniel ) <eos>
winnifred meets daniel <eos>	meet ( winnifred , daniel ) <eos>	meet ( winnifred , daniel ) <eos>
grace sees samuel <eos>	see ( grace , samuel ) <eos>	see ( grace , samuel ) <eos>
quinn knows xerxes <eos>	know ( quinn , xerxes ) <eos>	know ( quinn , xerxes ) <eos>
daniel notices winnifred <eos>	notice ( daniel , winnifred ) <eos>	notice ( daniel , winnifred ) <eos>
neha notices zelda <eos>	notice ( neha , zelda ) <eos>	notice ( neha , zelda ) <eos>
rachael sees herself <eos>	see ( rachael , rachael ) <eos>	see ( rachael , rachael ) <eos>
bob throws winnifred <eos>	throw ( bob , winnifred ) <eos>	throw ( bob , winnifred ) <eos>
rachael knows bob <eos>	know ( rachael , bob ) <eos>	know ( rachael , bob ) <eos>
yvette likes katherine <eos>	like ( yvettte , katherine ) <eos>	like ( yvettte , katherine ) <eos>
every actor sees bob <eos>	all x . ( actor ( x ) -> see ( x , bob ) ) <eos>	all x . ( actor ( x ) -> see ( x , bob ) ) <eos>
every actor notices ursula <eos>	all x . ( actor ( x ) -> notice ( x , ursula ) ) <eos>	all x . ( actor ( x ) -> see ( x , ursula ) ) <eos>
everyone throws yvette <eos>	all x . ( person ( x ) -> throw ( x , yvettte ) ) <eos>	all x . ( person ( x ) -> see ( x , yvettte ) ) <eos>
every turtle throws herself <eos>	all x . ( turtle ( x ) -> throw ( x , x ) ) <eos>	all x . ( actor ( x ) -> notice ( x , x ) ) <eos>
someone sees isla <eos>	exists x . ( person ( x ) & see ( x , isla ) ) <eos>	exists x . ( person ( x ) & see ( x , isla ) ) <eos>
every person likes winnifred <eos>	all x . ( person ( x ) -> like ( x , winnifred ) ) <eos>	all x . ( person ( x ) -> see ( x , winnifred ) ) <eos>
everyone likes herself <eos>	all x . ( person ( x ) -> like ( x , x ) ) <eos>	all x . ( person ( x ) -> see ( x , x ) ) <eos>
every actor sees lewis <eos>	all x . ( actor ( x ) -> see ( x , lewis ) ) <eos>	all x . ( actor ( x ) -> throw ( x , lewis ) ) <eos>
every prion notices margaret <eos>	all x . ( prion ( x ) -> notice ( x , margaret ) ) <eos>	all x . ( dog ( x ) -> meet ( x , margaret ) ) <eos>
every actor throws bob <eos>	all x . ( actor ( x ) -> throw ( x , bob ) ) <eos>	all x . ( actor ( x ) -> see ( x , bob ) ) <eos>
every turtle notices herself <eos>	all x . ( turtle ( x ) -> notice ( x , x ) ) <eos>	all x . ( turtle ( x ) -> notice ( x , x ) ) <eos>
every person likes henry <eos>	all x . ( person ( x ) -> like ( x , henry ) ) <eos>	all x . ( person ( x ) -> notice ( x , henry ) ) <eos>
every prion dislikes henry <eos>	all x . ( prion ( x ) -> dislike ( x , henry ) ) <eos>	all x . ( bear ( x ) -> see ( x , henry ) ) <eos>
every prion notices alice <eos>	all x . ( prion ( x ) -> notice ( x , alice ) ) <eos>	all x . ( prion ( x ) -> see ( x , alice ) ) <eos>
every dog notices katherine <eos>	all x . ( dog ( x ) -> notice ( x , katherine ) ) <eos>	all x . ( prion ( x ) -> meet ( x , katherine ) ) <eos>
every person meets tracy <eos>	all x . ( person ( x ) -> meet ( x , tracy ) ) <eos>	all x . ( person ( x ) -> notice ( x , tracy ) ) <eos>
someone notices daniel <eos>	exists x . ( person ( x ) & notice ( x , daniel ) ) <eos>	exists x . ( person ( x ) & know ( x , daniel ) ) <eos>
someone knows grace <eos>	exists x . ( person ( x ) & know ( x , grace ) ) <eos>	exists x . ( person ( x ) & know ( x , grace ) ) <eos>
everyone sees daniel <eos>	all x . ( person ( x ) -> see ( x , daniel ) ) <eos>	all x . ( person ( x ) -> see ( x , daniel ) ) <eos>
every prion sees quinn <eos>	all x . ( prion ( x ) -> see ( x , quinn ) ) <eos>	all x . ( dog ( x ) -> meet ( x , quinn ) ) <eos>
samuel notices katherine <eos>	notice ( samuel , katherine ) <eos>	notice ( samuel , katherine ) <eos>
isla dislikes katherine <eos>	dislike ( isla , katherine ) <eos>	dislike ( isla , katherine ) <eos>
xerxes notices bob <eos>	notice ( xerxes , bob ) <eos>	notice ( xerxes , bob ) <eos>
oswald dislikes ursula <eos>	dislike ( oswald , ursula ) <eos>	dislike ( oswald , ursula ) <eos>
neha notices eliza <eos>	notice ( neha , eliza ) <eos>	notice ( neha , eliza ) <eos>
every hoplite dislikes francis <eos>	all x . ( hoplite ( x ) -> dislike ( x , francis ) ) <eos>	all x . ( hoplite ( x ) -> see ( x , francis ) ) <eos>
every person knows henry <eos>	all x . ( person ( x ) -> know ( x , henry ) ) <eos>	all x . ( person ( x ) -> notice ( x , henry ) ) <eos>
every bear notices xerxes <eos>	all x . ( bear ( x ) -> notice ( x , xerxes ) ) <eos>	all x . ( bear ( x ) -> notice ( x , xerxes ) ) <eos>
everyone dislikes xerxes <eos>	all x . ( person ( x ) -> dislike ( x , xerxes ) ) <eos>	all x . ( person ( x ) -> notice ( x , xerxes ) ) <eos>
every turtle meets oswald <eos>	all x . ( turtle ( x ) -> meet ( x , oswald ) ) <eos>	all x . ( turtle ( x ) -> notice ( x , oswald ) ) <eos>
samuel likes patricia <eos>	like ( samuel , patricia ) <eos>	like ( samuel , patricia ) <eos>
neha knows henry <eos>	know ( neha , henry ) <eos>	know ( neha , henry ) <eos>
rachael likes rachael <eos>	like ( rachael , rachael ) <eos>	like ( rachael , rachael ) <eos>
lewis notices grace <eos>	notice ( lewis , grace ) <eos>	notice ( lewis , grace ) <eos>
oswald sees patricia <eos>	see ( oswald , patricia ) <eos>	see ( oswald , patricia ) <eos>
ursula likes eliza <eos>	like ( ursula , eliza ) <eos>	like ( ursula , eliza ) <eos>
victor meets john <eos>	meet ( victor , john ) <eos>	meet ( victor , john ) <eos>
neha dislikes john <eos>	dislike ( neha , john ) <eos>	dislike ( neha , john ) <eos>
zelda meets john <eos>	meet ( zelda , john ) <eos>	meet ( zelda , john ) <eos>
katherine throws xerxes <eos>	throw ( katherine , xerxes ) <eos>	throw ( katherine , xerxes ) <eos>
tracy meets yvette <eos>	meet ( tracy , yvettte ) <eos>	meet ( tracy , yvettte ) <eos>
bob likes eliza <eos>	like ( bob , eliza ) <eos>	like ( bob , eliza ) <eos>
grace notices tracy <eos>	notice ( grace , tracy ) <eos>	notice ( grace , tracy ) <eos>
john knows grace <eos>	know ( john , grace ) <eos>	know ( john , grace ) <eos>
claire dislikes alice <eos>	dislike ( claire , alice ) <eos>	dislike ( claire , alice ) <eos>
bob likes victor <eos>	like ( bob , victor ) <eos>	like ( bob , victor ) <eos>
grace knows victor <eos>	know ( grace , victor ) <eos>	know ( grace , victor ) <eos>
yvette notices bob <eos>	notice ( yvettte , bob ) <eos>	notice ( yvettte , bob ) <eos>
francis dislikes patricia <eos>	dislike ( francis , patricia ) <eos>	dislike ( francis , patricia ) <eos>
daniel sees henry <eos>	see ( daniel , henry ) <eos>	see ( daniel , henry ) <eos>
henry throws quinn <eos>	throw ( henry , quinn ) <eos>	throw ( henry , quinn ) <eos>
samuel sees francis <eos>	see ( samuel , francis ) <eos>	see ( samuel , francis ) <eos>
katherine likes ursula <eos>	like ( katherine , ursula ) <eos>	like ( katherine , ursula ) <eos>
rachael notices john <eos>	notice ( rachael , john ) <eos>	notice ( rachael , john ) <eos>
grace throws herself <eos>	throw ( grace , grace ) <eos>	throw ( grace , grace ) <eos>
every person throws zelda <eos>	all x . ( person ( x ) -> throw ( x , zelda ) ) <eos>	all x . ( person ( x ) -> notice ( x , zelda ) ) <eos>
every person throws xerxes <eos>	all x . ( person ( x ) -> throw ( x , xerxes ) ) <eos>	all x . ( person ( x ) -> notice ( x , xerxes ) ) <eos>
someone sees xerxes <eos>	exists x . ( person ( x ) & see ( x , xerxes ) ) <eos>	exists x . ( person ( x ) & see ( x , xerxes ) ) <eos>
every bear notices rachael <eos>	all x . ( bear ( x ) -> notice ( x , rachael ) ) <eos>	all x . ( bear ( x ) -> see ( x , rachael ) ) <eos>
everyone knows daniel <eos>	all x . ( person ( x ) -> know ( x , daniel ) ) <eos>	all x . ( person ( x ) -> see ( x , daniel ) ) <eos>
claire likes henry <eos>	like ( claire , henry ) <eos>	like ( claire , henry ) <eos>
quinn dislikes victor <eos>	dislike ( quinn , victor ) <eos>	dislike ( quinn , victor ) <eos>
isla dislikes victor <eos>	dislike ( isla , victor ) <eos>	dislike ( isla , victor ) <eos>
margaret throws grace <eos>	throw ( margaret , grace ) <eos>	throw ( margaret , grace ) <eos>
francis knows tracy <eos>	know ( francis , tracy ) <eos>	know ( francis , tracy ) <eos>
every turtle sees quinn <eos>	all x . ( turtle ( x ) -> see ( x , quinn ) ) <eos>	all x . ( turtle ( x ) -> meet ( x , quinn ) ) <eos>
someone throws zelda <eos>	exists x . ( person ( x ) & throw ( x , zelda ) ) <eos>	exists x . ( person ( x ) & like ( x , zelda ) ) <eos>
every turtle likes bob <eos>	all x . ( turtle ( x ) -> like ( x , bob ) ) <eos>	all x . ( turtle ( x ) -> see ( x , bob ) ) <eos>
everyone notices himself <eos>	all x . ( person ( x ) -> notice ( x , x ) ) <eos>	all x . ( person ( x ) -> see ( x , x ) ) <eos>
every dog meets margaret <eos>	all x . ( dog ( x ) -> meet ( x , margaret ) ) <eos>	all x . ( dog ( x ) -> meet ( x , margaret ) ) <eos>
every condor meets alice <eos>	all x . ( condor ( x ) -> meet ( x , alice ) ) <eos>	all x . ( bear ( x ) -> meet ( x , alice ) ) <eos>
every person knows yvette <eos>	all x . ( person ( x ) -> know ( x , yvettte ) ) <eos>	all x . ( person ( x ) -> see ( x , yvettte ) ) <eos>
every bear sees victor <eos>	all x . ( bear ( x ) -> see ( x , victor ) ) <eos>	all x . ( bear ( x ) -> notice ( x , victor ) ) <eos>
every dog meets francis <eos>	all x . ( dog ( x ) -> meet ( x , francis ) ) <eos>	all x . ( dog ( x ) -> meet ( x , francis ) ) <eos>
every bear likes daniel <eos>	all x . ( bear ( x ) -> like ( x , daniel ) ) <eos>	all x . ( condor ( x ) -> see ( x , daniel ) ) <eos>
bob throws rachael <eos>	throw ( bob , rachael ) <eos>	throw ( bob , rachael ) <eos>
margaret dislikes rachael <eos>	dislike ( margaret , rachael ) <eos>	dislike ( margaret , rachael ) <eos>
eliza knows eliza <eos>	know ( eliza , eliza ) <eos>	know ( eliza , eliza ) <eos>
claire knows xerxes <eos>	know ( claire , xerxes ) <eos>	know ( claire , xerxes ) <eos>
oswald likes samuel <eos>	like ( oswald , samuel ) <eos>	like ( oswald , samuel ) <eos>
francis likes himself <eos>	like ( francis , francis ) <eos>	like ( francis , francis ) <eos>
margaret likes patricia <eos>	like ( margaret , patricia ) <eos>	like ( margaret , patricia ) <eos>
isla knows claire <eos>	know ( isla , claire ) <eos>	know ( isla , claire ) <eos>
quinn notices margaret <eos>	notice ( quinn , margaret ) <eos>	notice ( quinn , margaret ) <eos>
zelda knows francis <eos>	know ( zelda , francis ) <eos>	know ( zelda , francis ) <eos>
grace throws xerxes <eos>	throw ( grace , xerxes ) <eos>	throw ( grace , xerxes ) <eos>
alice sees tracy <eos>	see ( alice , tracy ) <eos>	see ( alice , tracy ) <eos>
yvette throws oswald <eos>	throw ( yvettte , oswald ) <eos>	throw ( yvettte , oswald ) <eos>
henry meets rachael <eos>	meet ( henry , rachael ) <eos>	meet ( henry , rachael ) <eos>
claire notices oswald <eos>	notice ( claire , oswald ) <eos>	notice ( claire , oswald ) <eos>
ursula likes neha <eos>	like ( ursula , neha ) <eos>	like ( ursula , neha ) <eos>
rachael throws xerxes <eos>	throw ( rachael , xerxes ) <eos>	throw ( rachael , xerxes ) <eos>
quinn knows patricia <eos>	know ( quinn , patricia ) <eos>	know ( quinn , patricia ) <eos>
samuel meets john <eos>	meet ( samuel , john ) <eos>	meet ( samuel , john ) <eos>
tracy meets quinn <eos>	meet ( tracy , quinn ) <eos>	meet ( tracy , quinn ) <eos>
every condor likes quinn <eos>	all x . ( condor ( x ) -> like ( x , quinn ) ) <eos>	all x . ( bear ( x ) -> dislike ( x , quinn ) ) <eos>
every turtle knows victor <eos>	all x . ( turtle ( x ) -> know ( x , victor ) ) <eos>	all x . ( turtle ( x ) -> notice ( x , victor ) ) <eos>
everyone likes yvette <eos>	all x . ( person ( x ) -> like ( x , yvettte ) ) <eos>	all x . ( person ( x ) -> see ( x , yvettte ) ) <eos>
every hoplite likes yvette <eos>	all x . ( hoplite ( x ) -> like ( x , yvettte ) ) <eos>	all x . ( hoplite ( x ) -> meet ( x , yvettte ) ) <eos>
every person dislikes herself <eos>	all x . ( person ( x ) -> dislike ( x , x ) ) <eos>	all x . ( person ( x ) -> see ( x , x ) ) <eos>
bob notices ursula <eos>	notice ( bob , ursula ) <eos>	notice ( bob , ursula ) <eos>
winnifred meets zelda <eos>	meet ( winnifred , zelda ) <eos>	meet ( winnifred , zelda ) <eos>
lewis sees rachael <eos>	see ( lewis , rachael ) <eos>	see ( lewis , rachael ) <eos>
claire notices francis <eos>	notice ( claire , francis ) <eos>	notice ( claire , francis ) <eos>
katherine notices margaret <eos>	notice ( katherine , margaret ) <eos>	notice ( katherine , margaret ) <eos>
every condor sees oswald <eos>	all x . ( condor ( x ) -> see ( x , oswald ) ) <eos>	all x . ( bear ( x ) -> see ( x , oswald ) ) <eos>
every person meets ursula <eos>	all x . ( person ( x ) -> meet ( x , ursula ) ) <eos>	all x . ( person ( x ) -> see ( x , ursula ) ) <eos>
every turtle sees herself <eos>	all x . ( turtle ( x ) -> see ( x , x ) ) <eos>	all x . ( actor ( x ) -> see ( x , x ) ) <eos>
every person notices patricia <eos>	all x . ( person ( x ) -> notice ( x , patricia ) ) <eos>	all x . ( person ( x ) -> throw ( x , patricia ) ) <eos>
every dog likes ursula <eos>	all x . ( dog ( x ) -> like ( x , ursula ) ) <eos>	all x . ( dog ( x ) -> see ( x , ursula ) ) <eos>
every hoplite sees samuel <eos>	all x . ( hoplite ( x ) -> see ( x , samuel ) ) <eos>	all x . ( hoplite ( x ) -> see ( x , samuel ) ) <eos>
everyone likes tracy <eos>	all x . ( person ( x ) -> like ( x , tracy ) ) <eos>	all x . ( person ( x ) -> see ( x , tracy ) ) <eos>
every turtle sees himself <eos>	all x . ( turtle ( x ) -> see ( x , x ) ) <eos>	all x . ( actor ( x ) -> see ( x , claire ) ) <eos>
every condor dislikes zelda <eos>	all x . ( condor ( x ) -> dislike ( x , zelda ) ) <eos>	all x . ( bear ( x ) -> notice ( x , zelda ) ) <eos>
every dog knows francis <eos>	all x . ( dog ( x ) -> know ( x , francis ) ) <eos>	all x . ( dog ( x ) -> meet ( x , francis ) ) <eos>
grace sees lewis <eos>	see ( grace , lewis ) <eos>	see ( grace , lewis ) <eos>
ursula likes lewis <eos>	like ( ursula , lewis ) <eos>	like ( ursula , lewis ) <eos>
xerxes notices grace <eos>	notice ( xerxes , grace ) <eos>	notice ( xerxes , grace ) <eos>
tracy sees john <eos>	see ( tracy , john ) <eos>	see ( tracy , john ) <eos>
bob meets katherine <eos>	meet ( bob , katherine ) <eos>	meet ( bob , katherine ) <eos>
katherine throws alice <eos>	throw ( katherine , alice ) <eos>	throw ( katherine , alice ) <eos>
quinn notices xerxes <eos>	notice ( quinn , xerxes ) <eos>	notice ( quinn , xerxes ) <eos>
katherine sees bob <eos>	see ( katherine , bob ) <eos>	see ( katherine , bob ) <eos>
neha sees eliza <eos>	see ( neha , eliza ) <eos>	see ( neha , eliza ) <eos>
margaret throws rachael <eos>	throw ( margaret , rachael ) <eos>	throw ( margaret , rachael ) <eos>
john meets claire <eos>	meet ( john , claire ) <eos>	meet ( john , claire ) <eos>
patricia knows bob <eos>	know ( patricia , bob ) <eos>	know ( patricia , bob ) <eos>
rachael notices daniel <eos>	notice ( rachael , daniel ) <eos>	notice ( rachael , daniel ) <eos>
xerxes notices patricia <eos>	notice ( xerxes , patricia ) <eos>	notice ( xerxes , patricia ) <eos>
lewis likes henry <eos>	like ( lewis , henry ) <eos>	like ( lewis , henry ) <eos>
every condor throws zelda <eos>	all x . ( condor ( x ) -> throw ( x , zelda ) ) <eos>	all x . ( bear ( x ) -> notice ( x , zelda ) ) <eos>
every actor knows isla <eos>	all x . ( actor ( x ) -> know ( x , isla ) ) <eos>	all x . ( actor ( x ) -> meet ( x , isla ) ) <eos>
every turtle knows herself <eos>	all x . ( turtle ( x ) -> know ( x , x ) ) <eos>	all x . ( turtle ( x ) -> see ( x , x ) ) <eos>
every condor notices grace <eos>	all x . ( condor ( x ) -> notice ( x , grace ) ) <eos>	all x . ( bear ( x ) -> see ( x , grace ) ) <eos>
everyone notices claire <eos>	all x . ( person ( x ) -> notice ( x , claire ) ) <eos>	all x . ( person ( x ) -> see ( x , claire ) ) <eos>
every actor notices xerxes <eos>	all x . ( actor ( x ) -> notice ( x , xerxes ) ) <eos>	all x . ( actor ( x ) -> notice ( x , xerxes ) ) <eos>
every condor sees himself <eos>	all x . ( condor ( x ) -> see ( x , x ) ) <eos>	all x . ( bear ( x ) -> see ( x , x ) ) <eos>
alice throws lewis <eos>	throw ( alice , lewis ) <eos>	throw ( alice , lewis ) <eos>
john likes yvette <eos>	like ( john , yvettte ) <eos>	like ( john , yvettte ) <eos>
winnifred likes quinn <eos>	like ( winnifred , quinn ) <eos>	like ( winnifred , quinn ) <eos>
daniel likes victor <eos>	like ( daniel , victor ) <eos>	like ( daniel , victor ) <eos>
grace notices winnifred <eos>	notice ( grace , winnifred ) <eos>	notice ( grace , winnifred ) <eos>
claire meets yvette <eos>	meet ( claire , yvettte ) <eos>	meet ( claire , yvettte ) <eos>
daniel sees eliza <eos>	see ( daniel , eliza ) <eos>	see ( daniel , eliza ) <eos>
grace dislikes quinn <eos>	dislike ( grace , quinn ) <eos>	dislike ( grace , quinn ) <eos>
yvette knows xerxes <eos>	know ( yvettte , xerxes ) <eos>	know ( yvettte , xerxes ) <eos>
isla throws ursula <eos>	throw ( isla , ursula ) <eos>	throw ( isla , ursula ) <eos>
xerxes knows margaret <eos>	know ( xerxes , margaret ) <eos>	know ( xerxes , margaret ) <eos>
katherine throws claire <eos>	throw ( katherine , claire ) <eos>	throw ( katherine , claire ) <eos>
winnifred sees neha <eos>	see ( winnifred , neha ) <eos>	see ( winnifred , neha ) <eos>
henry dislikes bob <eos>	dislike ( henry , bob ) <eos>	dislike ( henry , bob ) <eos>
lewis meets john <eos>	meet ( lewis , john ) <eos>	meet ( lewis , john ) <eos>
margaret dislikes ursula <eos>	dislike ( margaret , ursula ) <eos>	dislike ( margaret , ursula ) <eos>
ursula sees samuel <eos>	see ( ursula , samuel ) <eos>	see ( ursula , samuel ) <eos>
eliza notices neha <eos>	notice ( eliza , neha ) <eos>	notice ( eliza , neha ) <eos>
henry knows patricia <eos>	know ( henry , patricia ) <eos>	know ( henry , patricia ) <eos>
zelda dislikes ursula <eos>	dislike ( zelda , ursula ) <eos>	dislike ( zelda , ursula ) <eos>
grace meets yvette <eos>	meet ( grace , yvettte ) <eos>	meet ( grace , yvettte ) <eos>
oswald dislikes rachael <eos>	dislike ( oswald , rachael ) <eos>	dislike ( oswald , rachael ) <eos>
tracy likes daniel <eos>	like ( tracy , daniel ) <eos>	like ( tracy , daniel ) <eos>
grace meets isla <eos>	meet ( grace , isla ) <eos>	meet ( grace , isla ) <eos>
lewis throws eliza <eos>	throw ( lewis , eliza ) <eos>	throw ( lewis , eliza ) <eos>
eliza meets samuel <eos>	meet ( eliza , samuel ) <eos>	meet ( eliza , samuel ) <eos>
claire likes katherine <eos>	like ( claire , katherine ) <eos>	like ( claire , katherine ) <eos>
zelda dislikes alice <eos>	dislike ( zelda , alice ) <eos>	dislike ( zelda , alice ) <eos>
bob sees katherine <eos>	see ( bob , katherine ) <eos>	see ( bob , katherine ) <eos>
patricia knows claire <eos>	know ( patricia , claire ) <eos>	know ( patricia , claire ) <eos>
everyone likes claire <eos>	all x . ( person ( x ) -> like ( x , claire ) ) <eos>	all x . ( person ( x ) -> dislike ( x , claire ) ) <eos>
every bear notices samuel <eos>	all x . ( bear ( x ) -> notice ( x , samuel ) ) <eos>	all x . ( bear ( x ) -> like ( x , samuel ) ) <eos>
every condor notices bob <eos>	all x . ( condor ( x ) -> notice ( x , bob ) ) <eos>	all x . ( bear ( x ) -> see ( x , bob ) ) <eos>
every dog throws rachael <eos>	all x . ( dog ( x ) -> throw ( x , rachael ) ) <eos>	all x . ( dog ( x ) -> meet ( x , rachael ) ) <eos>
every turtle likes ursula <eos>	all x . ( turtle ( x ) -> like ( x , ursula ) ) <eos>	all x . ( hoplite ( x ) -> see ( x , ursula ) ) <eos>
