source	transformation	target
Alice sees Bob	sem	see ( alice , bob )
Alice sees Claire	sem	see ( alice , claire )
Alice sees Daniel	sem	see ( alice , daniel )
Alice sees Eliza	sem	see ( alice , eliza )
Alice sees Francis	sem	see ( alice , francis )
Alice sees Grace	sem	see ( alice , grace )
Alice sees Henry	sem	see ( alice , henry )
Alice sees Isla	sem	see ( alice , isla )
Alice sees John	sem	see ( alice , john )
Alice sees Katherine	sem	see ( alice , katherine )
Alice sees Lewis	sem	see ( alice , lewis )
Alice sees Neha	sem	see ( alice , neha )
Alice sees Oswald	sem	see ( alice , oswald )
Alice sees Patricia	sem	see ( alice , patricia )
Alice sees Quinn	sem	see ( alice , quinn )
Alice sees Rachael	sem	see ( alice , rachael )
Alice sees Samuel	sem	see ( alice , samuel )
Alice sees Tracy	sem	see ( alice , tracy )
Alice sees Ursula	sem	see ( alice , ursula )
Alice sees Victor	sem	see ( alice , victor )
Alice sees Winnifred	sem	see ( alice , winnifred )
Alice sees Xerxes	sem	see ( alice , xerxes )
Alice meets Bob	sem	meet ( alice , bob )
Alice meets Claire	sem	meet ( alice , claire )
Alice meets Daniel	sem	meet ( alice , daniel )
Alice meets Eliza	sem	meet ( alice , eliza )
Alice meets Francis	sem	meet ( alice , francis )
Alice meets Henry	sem	meet ( alice , henry )
Alice meets Isla	sem	meet ( alice , isla )
Alice meets John	sem	meet ( alice , john )
Alice meets Katherine	sem	meet ( alice , katherine )
Alice meets Margaret	sem	meet ( alice , margaret )
Alice meets Neha	sem	meet ( alice , neha )
Alice meets Patricia	sem	meet ( alice , patricia )
Alice meets Quinn	sem	meet ( alice , quinn )
Alice meets Rachael	sem	meet ( alice , rachael )
Alice meets Samuel	sem	meet ( alice , samuel )
Alice meets Tracy	sem	meet ( alice , tracy )
Alice meets Ursula	sem	meet ( alice , ursula )
Alice meets Victor	sem	meet ( alice , victor )
Alice meets Winnifred	sem	meet ( alice , winnifred )
Alice meets Xerxes	sem	meet ( alice , xerxes )
Alice meets Yvette	sem	meet ( alice , yvettte )
Alice likes Claire	sem	like ( alice , claire )
Alice likes Daniel	sem	like ( alice , daniel )
Alice likes Francis	sem	like ( alice , francis )
Alice likes Grace	sem	like ( alice , grace )
Alice likes Henry	sem	like ( alice , henry )
Alice likes Isla	sem	like ( alice , isla )
Alice likes John	sem	like ( alice , john )
Alice likes Katherine	sem	like ( alice , katherine )
Alice likes Lewis	sem	like ( alice , lewis )
Alice likes Margaret	sem	like ( alice , margaret )
Alice likes Neha	sem	like ( alice , neha )
Alice likes Patricia	sem	like ( alice , patricia )
Alice likes Quinn	sem	like ( alice , quinn )
Alice likes Tracy	sem	like ( alice , tracy )
Alice likes Ursula	sem	like ( alice , ursula )
Alice likes Victor	sem	like ( alice , victor )
Alice likes Xerxes	sem	like ( alice , xerxes )
Alice likes Yvette	sem	like ( alice , yvettte )
Alice likes Zelda	sem	like ( alice , zelda )
Alice dislikes Claire	sem	dislike ( alice , claire )
Alice dislikes Daniel	sem	dislike ( alice , daniel )
Alice dislikes Eliza	sem	dislike ( alice , eliza )
Alice dislikes Isla	sem	dislike ( alice , isla )
Alice dislikes John	sem	dislike ( alice , john )
Alice dislikes Lewis	sem	dislike ( alice , lewis )
Alice dislikes Margaret	sem	dislike ( alice , margaret )
Alice dislikes Neha	sem	dislike ( alice , neha )
Alice dislikes Oswald	sem	dislike ( alice , oswald )
Alice dislikes Patricia	sem	dislike ( alice , patricia )
Alice dislikes Quinn	sem	dislike ( alice , quinn )
Alice dislikes Rachael	sem	dislike ( alice , rachael )
Alice dislikes Tracy	sem	dislike ( alice , tracy )
Alice dislikes Ursula	sem	dislike ( alice , ursula )
Alice dislikes Victor	sem	dislike ( alice , victor )
Alice dislikes Winnifred	sem	dislike ( alice , winnifred )
Alice dislikes Xerxes	sem	dislike ( alice , xerxes )
Alice dislikes Yvette	sem	dislike ( alice , yvettte )
Alice throws Bob	sem	throw ( alice , bob )
Alice throws Claire	sem	throw ( alice , claire )
Alice throws Daniel	sem	throw ( alice , daniel )
Alice throws Eliza	sem	throw ( alice , eliza )
Alice throws Francis	sem	throw ( alice , francis )
Alice throws Henry	sem	throw ( alice , henry )
Alice throws John	sem	throw ( alice , john )
Alice throws Lewis	sem	throw ( alice , lewis )
Alice throws Oswald	sem	throw ( alice , oswald )
Alice throws Patricia	sem	throw ( alice , patricia )
Alice throws Quinn	sem	throw ( alice , quinn )
Alice throws Rachael	sem	throw ( alice , rachael )
Alice throws Samuel	sem	throw ( alice , samuel )
Alice throws Tracy	sem	throw ( alice , tracy )
Alice throws Ursula	sem	throw ( alice , ursula )
Alice throws Victor	sem	throw ( alice , victor )
Alice throws Winnifred	sem	throw ( alice , winnifred )
Alice throws Xerxes	sem	throw ( alice , xerxes )
Alice throws Zelda	sem	throw ( alice , zelda )
Alice notices Bob	sem	notice ( alice , bob )
Alice notices Daniel	sem	notice ( alice , daniel )
Alice notices Eliza	sem	notice ( alice , eliza )
Alice notices Francis	sem	notice ( alice , francis )
Alice notices Henry	sem	notice ( alice , henry )
Alice notices Isla	sem	notice ( alice , isla )
Alice notices John	sem	notice ( alice , john )
Alice notices Katherine	sem	notice ( alice , katherine )
Alice notices Lewis	sem	notice ( alice , lewis )
Alice notices Neha	sem	notice ( alice , neha )
Alice notices Oswald	sem	notice ( alice , oswald )
Alice notices Patricia	sem	notice ( alice , patricia )
Alice notices Quinn	sem	notice ( alice , quinn )
Alice notices Rachael	sem	notice ( alice , rachael )
Alice notices Samuel	sem	notice ( alice , samuel )
Alice notices Tracy	sem	notice ( alice , tracy )
Alice notices Ursula	sem	notice ( alice , ursula )
Alice notices Victor	sem	notice ( alice , victor )
Alice notices Winnifred	sem	notice ( alice , winnifred )
Alice notices Xerxes	sem	notice ( alice , xerxes )
Alice notices Yvette	sem	notice ( alice , yvettte )
Alice knows Bob	sem	know ( alice , bob )
Alice knows Claire	sem	know ( alice , claire )
Alice knows Grace	sem	know ( alice , grace )
Alice knows Henry	sem	know ( alice , henry )
Alice knows Isla	sem	know ( alice , isla )
Alice knows John	sem	know ( alice , john )
Alice knows Katherine	sem	know ( alice , katherine )
Alice knows Lewis	sem	know ( alice , lewis )
Alice knows Neha	sem	know ( alice , neha )
Alice knows Patricia	sem	know ( alice , patricia )
Alice knows Quinn	sem	know ( alice , quinn )
Alice knows Rachael	sem	know ( alice , rachael )
Alice knows Tracy	sem	know ( alice , tracy )
Alice knows Victor	sem	know ( alice , victor )
Alice knows Winnifred	sem	know ( alice , winnifred )
Alice knows Xerxes	sem	know ( alice , xerxes )
Alice knows Yvette	sem	know ( alice , yvettte )
Alice knows Zelda	sem	know ( alice , zelda )
Bob walks	sem	walk ( bob )
Bob sleeps	sem	sleep ( bob )
Bob eats	sem	eat ( bob )
Bob runs	sem	run ( bob )
Bob sings	sem	sing ( bob )
Bob dances	sem	dance ( bob )
Bob flies	sem	fly ( bob )
Bob slumbers	sem	slumber ( bob )
Bob sees Bob	sem	see ( bob , bob )
Bob sees Claire	sem	see ( bob , claire )
Bob sees Daniel	sem	see ( bob , daniel )
Bob sees Eliza	sem	see ( bob , eliza )
Bob sees Francis	sem	see ( bob , francis )
Bob sees Grace	sem	see ( bob , grace )
Bob sees Henry	sem	see ( bob , henry )
Bob sees Isla	sem	see ( bob , isla )
Bob sees John	sem	see ( bob , john )
Bob sees Katherine	sem	see ( bob , katherine )
Bob sees Lewis	sem	see ( bob , lewis )
Bob sees Margaret	sem	see ( bob , margaret )
Bob sees Oswald	sem	see ( bob , oswald )
Bob sees Patricia	sem	see ( bob , patricia )
Bob sees Quinn	sem	see ( bob , quinn )
Bob sees Samuel	sem	see ( bob , samuel )
Bob sees Ursula	sem	see ( bob , ursula )
Bob sees Victor	sem	see ( bob , victor )
Bob sees Winnifred	sem	see ( bob , winnifred )
Bob sees Xerxes	sem	see ( bob , xerxes )
Bob sees Zelda	sem	see ( bob , zelda )
Bob meets Claire	sem	meet ( bob , claire )
Bob meets Daniel	sem	meet ( bob , daniel )
Bob meets Francis	sem	meet ( bob , francis )
Bob meets Grace	sem	meet ( bob , grace )
Bob meets Henry	sem	meet ( bob , henry )
Bob meets Isla	sem	meet ( bob , isla )
Bob meets John	sem	meet ( bob , john )
Bob meets Katherine	sem	meet ( bob , katherine )
Bob meets Lewis	sem	meet ( bob , lewis )
Bob meets Margaret	sem	meet ( bob , margaret )
Bob meets Neha	sem	meet ( bob , neha )
Bob meets Oswald	sem	meet ( bob , oswald )
Bob meets Patricia	sem	meet ( bob , patricia )
Bob meets Quinn	sem	meet ( bob , quinn )
Bob meets Rachael	sem	meet ( bob , rachael )
Bob meets Tracy	sem	meet ( bob , tracy )
Bob meets Ursula	sem	meet ( bob , ursula )
Bob meets Victor	sem	meet ( bob , victor )
Bob meets Winnifred	sem	meet ( bob , winnifred )
Bob meets Xerxes	sem	meet ( bob , xerxes )
Bob meets Yvette	sem	meet ( bob , yvettte )
Bob meets Zelda	sem	meet ( bob , zelda )
Bob likes Bob	sem	like ( bob , bob )
Bob likes Daniel	sem	like ( bob , daniel )
Bob likes Francis	sem	like ( bob , francis )
Bob likes Isla	sem	like ( bob , isla )
Bob likes Katherine	sem	like ( bob , katherine )
Bob likes Lewis	sem	like ( bob , lewis )
Bob likes Margaret	sem	like ( bob , margaret )
Bob likes Neha	sem	like ( bob , neha )
Bob likes Patricia	sem	like ( bob , patricia )
Bob likes Quinn	sem	like ( bob , quinn )
Bob likes Rachael	sem	like ( bob , rachael )
Bob likes Samuel	sem	like ( bob , samuel )
Bob likes Tracy	sem	like ( bob , tracy )
Bob likes Ursula	sem	like ( bob , ursula )
Bob likes Victor	sem	like ( bob , victor )
Bob likes Yvette	sem	like ( bob , yvettte )
Bob dislikes Bob	sem	dislike ( bob , bob )
Bob dislikes Claire	sem	dislike ( bob , claire )
Bob dislikes Daniel	sem	dislike ( bob , daniel )
Bob dislikes Eliza	sem	dislike ( bob , eliza )
Bob dislikes Francis	sem	dislike ( bob , francis )
Bob dislikes Grace	sem	dislike ( bob , grace )
Bob dislikes Henry	sem	dislike ( bob , henry )
Bob dislikes Isla	sem	dislike ( bob , isla )
Bob dislikes John	sem	dislike ( bob , john )
Bob dislikes Katherine	sem	dislike ( bob , katherine )
Bob dislikes Lewis	sem	dislike ( bob , lewis )
Bob dislikes Margaret	sem	dislike ( bob , margaret )
Bob dislikes Neha	sem	dislike ( bob , neha )
Bob dislikes Oswald	sem	dislike ( bob , oswald )
Bob dislikes Patricia	sem	dislike ( bob , patricia )
Bob dislikes Quinn	sem	dislike ( bob , quinn )
Bob dislikes Rachael	sem	dislike ( bob , rachael )
Bob dislikes Ursula	sem	dislike ( bob , ursula )
Bob dislikes Yvette	sem	dislike ( bob , yvettte )
Bob dislikes Zelda	sem	dislike ( bob , zelda )
Bob throws Bob	sem	throw ( bob , bob )
Bob throws Claire	sem	throw ( bob , claire )
Bob throws Daniel	sem	throw ( bob , daniel )
Bob throws Eliza	sem	throw ( bob , eliza )
Bob throws Henry	sem	throw ( bob , henry )
Bob throws Isla	sem	throw ( bob , isla )
Bob throws Katherine	sem	throw ( bob , katherine )
Bob throws Lewis	sem	throw ( bob , lewis )
Bob throws Margaret	sem	throw ( bob , margaret )
Bob throws Neha	sem	throw ( bob , neha )
Bob throws Oswald	sem	throw ( bob , oswald )
Bob throws Patricia	sem	throw ( bob , patricia )
Bob throws Quinn	sem	throw ( bob , quinn )
Bob throws Samuel	sem	throw ( bob , samuel )
Bob throws Tracy	sem	throw ( bob , tracy )
Bob throws Ursula	sem	throw ( bob , ursula )
Bob throws Winnifred	sem	throw ( bob , winnifred )
Bob throws Xerxes	sem	throw ( bob , xerxes )
Bob throws Yvette	sem	throw ( bob , yvettte )
Bob throws Zelda	sem	throw ( bob , zelda )
Bob notices Bob	sem	notice ( bob , bob )
Bob notices Claire	sem	notice ( bob , claire )
Bob notices Daniel	sem	notice ( bob , daniel )
Bob notices Eliza	sem	notice ( bob , eliza )
Bob notices Francis	sem	notice ( bob , francis )
Bob notices Grace	sem	notice ( bob , grace )
Bob notices Henry	sem	notice ( bob , henry )
Bob notices Isla	sem	notice ( bob , isla )
Bob notices John	sem	notice ( bob , john )
Bob notices Katherine	sem	notice ( bob , katherine )
Bob notices Margaret	sem	notice ( bob , margaret )
Bob notices Neha	sem	notice ( bob , neha )
Bob notices Oswald	sem	notice ( bob , oswald )
Bob notices Patricia	sem	notice ( bob , patricia )
Bob notices Quinn	sem	notice ( bob , quinn )
Bob notices Rachael	sem	notice ( bob , rachael )
Bob notices Samuel	sem	notice ( bob , samuel )
Bob notices Tracy	sem	notice ( bob , tracy )
Bob notices Ursula	sem	notice ( bob , ursula )
Bob notices Victor	sem	notice ( bob , victor )
Bob notices Winnifred	sem	notice ( bob , winnifred )
Bob notices Xerxes	sem	notice ( bob , xerxes )
Bob notices Yvette	sem	notice ( bob , yvettte )
Bob knows Bob	sem	know ( bob , bob )
Bob knows Claire	sem	know ( bob , claire )
Bob knows Daniel	sem	know ( bob , daniel )
Bob knows Eliza	sem	know ( bob , eliza )
Bob knows Francis	sem	know ( bob , francis )
Bob knows Grace	sem	know ( bob , grace )
Bob knows Henry	sem	know ( bob , henry )
Bob knows Isla	sem	know ( bob , isla )
Bob knows John	sem	know ( bob , john )
Bob knows Katherine	sem	know ( bob , katherine )
Bob knows Lewis	sem	know ( bob , lewis )
Bob knows Margaret	sem	know ( bob , margaret )
Bob knows Neha	sem	know ( bob , neha )
Bob knows Oswald	sem	know ( bob , oswald )
Bob knows Quinn	sem	know ( bob , quinn )
Bob knows Rachael	sem	know ( bob , rachael )
Bob knows Samuel	sem	know ( bob , samuel )
Bob knows Tracy	sem	know ( bob , tracy )
Bob knows Ursula	sem	know ( bob , ursula )
Bob knows Victor	sem	know ( bob , victor )
Bob knows Winnifred	sem	know ( bob , winnifred )
Bob knows Xerxes	sem	know ( bob , xerxes )
Bob knows Yvette	sem	know ( bob , yvettte )
Bob sees himself	sem	see ( bob , bob )
Bob meets himself	sem	meet ( bob , bob )
Bob likes himself	sem	like ( bob , bob )
Bob dislikes himself	sem	dislike ( bob , bob )
Bob throws himself	sem	throw ( bob , bob )
Bob notices himself	sem	notice ( bob , bob )
Bob knows himself	sem	know ( bob , bob )
Claire walks	sem	walk ( claire )
Claire sleeps	sem	sleep ( claire )
Claire eats	sem	eat ( claire )
Claire dances	sem	dance ( claire )
Claire flies	sem	fly ( claire )
Claire sees Bob	sem	see ( claire , bob )
Claire sees Claire	sem	see ( claire , claire )
Claire sees Daniel	sem	see ( claire , daniel )
Claire sees Eliza	sem	see ( claire , eliza )
Claire sees Grace	sem	see ( claire , grace )
Claire sees Henry	sem	see ( claire , henry )
Claire sees Isla	sem	see ( claire , isla )
Claire sees John	sem	see ( claire , john )
Claire sees Katherine	sem	see ( claire , katherine )
Claire sees Lewis	sem	see ( claire , lewis )
Claire sees Margaret	sem	see ( claire , margaret )
Claire sees Neha	sem	see ( claire , neha )
Claire sees Oswald	sem	see ( claire , oswald )
Claire sees Patricia	sem	see ( claire , patricia )
Claire sees Quinn	sem	see ( claire , quinn )
Claire sees Rachael	sem	see ( claire , rachael )
Claire sees Samuel	sem	see ( claire , samuel )
Claire sees Tracy	sem	see ( claire , tracy )
Claire sees Winnifred	sem	see ( claire , winnifred )
Claire sees Xerxes	sem	see ( claire , xerxes )
Claire sees Yvette	sem	see ( claire , yvettte )
Claire sees Zelda	sem	see ( claire , zelda )
Claire meets Bob	sem	meet ( claire , bob )
Claire meets Claire	sem	meet ( claire , claire )
Claire meets Daniel	sem	meet ( claire , daniel )
Claire meets Eliza	sem	meet ( claire , eliza )
Claire meets Francis	sem	meet ( claire , francis )
Claire meets Grace	sem	meet ( claire , grace )
Claire meets Henry	sem	meet ( claire , henry )
Claire meets Isla	sem	meet ( claire , isla )
Claire meets John	sem	meet ( claire , john )
Claire meets Katherine	sem	meet ( claire , katherine )
Claire meets Margaret	sem	meet ( claire , margaret )
Claire meets Neha	sem	meet ( claire , neha )
Claire meets Oswald	sem	meet ( claire , oswald )
Claire meets Quinn	sem	meet ( claire , quinn )
Claire meets Rachael	sem	meet ( claire , rachael )
Claire meets Samuel	sem	meet ( claire , samuel )
Claire meets Tracy	sem	meet ( claire , tracy )
Claire meets Ursula	sem	meet ( claire , ursula )
Claire meets Victor	sem	meet ( claire , victor )
Claire meets Winnifred	sem	meet ( claire , winnifred )
Claire meets Xerxes	sem	meet ( claire , xerxes )
Claire meets Yvette	sem	meet ( claire , yvettte )
Claire meets Zelda	sem	meet ( claire , zelda )
Claire likes Claire	sem	like ( claire , claire )
Claire likes Daniel	sem	like ( claire , daniel )
Claire likes Eliza	sem	like ( claire , eliza )
Claire likes Francis	sem	like ( claire , francis )
Claire likes Grace	sem	like ( claire , grace )
Claire likes Isla	sem	like ( claire , isla )
Claire likes John	sem	like ( claire , john )
Claire likes Katherine	sem	like ( claire , katherine )
Claire likes Lewis	sem	like ( claire , lewis )
Claire likes Margaret	sem	like ( claire , margaret )
Claire likes Neha	sem	like ( claire , neha )
Claire likes Patricia	sem	like ( claire , patricia )
Claire likes Rachael	sem	like ( claire , rachael )
Claire likes Samuel	sem	like ( claire , samuel )
Claire likes Tracy	sem	like ( claire , tracy )
Claire likes Ursula	sem	like ( claire , ursula )
Claire likes Winnifred	sem	like ( claire , winnifred )
Claire likes Yvette	sem	like ( claire , yvettte )
Claire likes Zelda	sem	like ( claire , zelda )
Claire dislikes Claire	sem	dislike ( claire , claire )
Claire dislikes Francis	sem	dislike ( claire , francis )
Claire dislikes Grace	sem	dislike ( claire , grace )
Claire dislikes Isla	sem	dislike ( claire , isla )
Claire dislikes John	sem	dislike ( claire , john )
Claire dislikes Katherine	sem	dislike ( claire , katherine )
Claire dislikes Margaret	sem	dislike ( claire , margaret )
Claire dislikes Neha	sem	dislike ( claire , neha )
Claire dislikes Oswald	sem	dislike ( claire , oswald )
Claire dislikes Patricia	sem	dislike ( claire , patricia )
Claire dislikes Quinn	sem	dislike ( claire , quinn )
Claire dislikes Rachael	sem	dislike ( claire , rachael )
Claire dislikes Samuel	sem	dislike ( claire , samuel )
Claire dislikes Tracy	sem	dislike ( claire , tracy )
Claire dislikes Ursula	sem	dislike ( claire , ursula )
Claire dislikes Victor	sem	dislike ( claire , victor )
Claire dislikes Winnifred	sem	dislike ( claire , winnifred )
Claire dislikes Xerxes	sem	dislike ( claire , xerxes )
Claire dislikes Yvette	sem	dislike ( claire , yvettte )
Claire dislikes Zelda	sem	dislike ( claire , zelda )
Claire throws Daniel	sem	throw ( claire , daniel )
Claire throws Eliza	sem	throw ( claire , eliza )
Claire throws Grace	sem	throw ( claire , grace )
Claire throws Henry	sem	throw ( claire , henry )
Claire throws Isla	sem	throw ( claire , isla )
Claire throws Katherine	sem	throw ( claire , katherine )
Claire throws Lewis	sem	throw ( claire , lewis )
Claire throws Margaret	sem	throw ( claire , margaret )
Claire throws Neha	sem	throw ( claire , neha )
Claire throws Oswald	sem	throw ( claire , oswald )
Claire throws Patricia	sem	throw ( claire , patricia )
Claire throws Quinn	sem	throw ( claire , quinn )
Claire throws Samuel	sem	throw ( claire , samuel )
Claire throws Winnifred	sem	throw ( claire , winnifred )
Claire throws Xerxes	sem	throw ( claire , xerxes )
Claire throws Yvette	sem	throw ( claire , yvettte )
Claire throws Zelda	sem	throw ( claire , zelda )
Claire notices Bob	sem	notice ( claire , bob )
Claire notices Claire	sem	notice ( claire , claire )
Claire notices Eliza	sem	notice ( claire , eliza )
Claire notices Francis	sem	notice ( claire , francis )
Claire notices Henry	sem	notice ( claire , henry )
Claire notices John	sem	notice ( claire , john )
Claire notices Katherine	sem	notice ( claire , katherine )
Claire notices Margaret	sem	notice ( claire , margaret )
Claire notices Oswald	sem	notice ( claire , oswald )
Claire notices Patricia	sem	notice ( claire , patricia )
Claire notices Quinn	sem	notice ( claire , quinn )
Claire notices Rachael	sem	notice ( claire , rachael )
Claire notices Samuel	sem	notice ( claire , samuel )
Claire notices Tracy	sem	notice ( claire , tracy )
Claire notices Ursula	sem	notice ( claire , ursula )
Claire notices Winnifred	sem	notice ( claire , winnifred )
Claire notices Xerxes	sem	notice ( claire , xerxes )
Claire notices Yvette	sem	notice ( claire , yvettte )
Claire knows Bob	sem	know ( claire , bob )
Claire knows Claire	sem	know ( claire , claire )
Claire knows Daniel	sem	know ( claire , daniel )
Claire knows Eliza	sem	know ( claire , eliza )
Claire knows Grace	sem	know ( claire , grace )
Claire knows Henry	sem	know ( claire , henry )
Claire knows John	sem	know ( claire , john )
Claire knows Katherine	sem	know ( claire , katherine )
Claire knows Lewis	sem	know ( claire , lewis )
Claire knows Margaret	sem	know ( claire , margaret )
Claire knows Oswald	sem	know ( claire , oswald )
Claire knows Patricia	sem	know ( claire , patricia )
Claire knows Quinn	sem	know ( claire , quinn )
Claire knows Rachael	sem	know ( claire , rachael )
Claire knows Samuel	sem	know ( claire , samuel )
Claire knows Ursula	sem	know ( claire , ursula )
Claire knows Victor	sem	know ( claire , victor )
Claire knows Winnifred	sem	know ( claire , winnifred )
Claire knows Xerxes	sem	know ( claire , xerxes )
Claire knows Zelda	sem	know ( claire , zelda )
Claire sees herself	sem	see ( claire , claire )
Claire likes herself	sem	like ( claire , claire )
Claire dislikes herself	sem	dislike ( claire , claire )
Claire notices herself	sem	notice ( claire , claire )
Daniel eats	sem	eat ( daniel )
Daniel runs	sem	run ( daniel )
Daniel sings	sem	sing ( daniel )
Daniel dances	sem	dance ( daniel )
Daniel flies	sem	fly ( daniel )
Daniel sees Bob	sem	see ( daniel , bob )
Daniel sees Daniel	sem	see ( daniel , daniel )
Daniel sees Eliza	sem	see ( daniel , eliza )
Daniel sees Francis	sem	see ( daniel , francis )
Daniel sees Henry	sem	see ( daniel , henry )
Daniel sees Isla	sem	see ( daniel , isla )
Daniel sees John	sem	see ( daniel , john )
Daniel sees Katherine	sem	see ( daniel , katherine )
Daniel sees Lewis	sem	see ( daniel , lewis )
Daniel sees Neha	sem	see ( daniel , neha )
Daniel sees Oswald	sem	see ( daniel , oswald )
Daniel sees Patricia	sem	see ( daniel , patricia )
Daniel sees Quinn	sem	see ( daniel , quinn )
Daniel sees Rachael	sem	see ( daniel , rachael )
Daniel sees Samuel	sem	see ( daniel , samuel )
Daniel sees Tracy	sem	see ( daniel , tracy )
Daniel sees Winnifred	sem	see ( daniel , winnifred )
Daniel sees Xerxes	sem	see ( daniel , xerxes )
Daniel sees Yvette	sem	see ( daniel , yvettte )
Daniel sees Zelda	sem	see ( daniel , zelda )
Daniel meets Claire	sem	meet ( daniel , claire )
Daniel meets Daniel	sem	meet ( daniel , daniel )
Daniel meets Eliza	sem	meet ( daniel , eliza )
Daniel meets Francis	sem	meet ( daniel , francis )
Daniel meets Grace	sem	meet ( daniel , grace )
Daniel meets Henry	sem	meet ( daniel , henry )
Daniel meets Isla	sem	meet ( daniel , isla )
Daniel meets John	sem	meet ( daniel , john )
Daniel meets Katherine	sem	meet ( daniel , katherine )
Daniel meets Lewis	sem	meet ( daniel , lewis )
Daniel meets Margaret	sem	meet ( daniel , margaret )
Daniel meets Neha	sem	meet ( daniel , neha )
Daniel meets Patricia	sem	meet ( daniel , patricia )
Daniel meets Quinn	sem	meet ( daniel , quinn )
Daniel meets Rachael	sem	meet ( daniel , rachael )
Daniel meets Samuel	sem	meet ( daniel , samuel )
Daniel meets Ursula	sem	meet ( daniel , ursula )
Daniel meets Victor	sem	meet ( daniel , victor )
Daniel meets Winnifred	sem	meet ( daniel , winnifred )
Daniel meets Xerxes	sem	meet ( daniel , xerxes )
Daniel meets Yvette	sem	meet ( daniel , yvettte )
Daniel meets Zelda	sem	meet ( daniel , zelda )
Daniel likes Bob	sem	like ( daniel , bob )
Daniel likes Daniel	sem	like ( daniel , daniel )
Daniel likes Eliza	sem	like ( daniel , eliza )
Daniel likes Francis	sem	like ( daniel , francis )
Daniel likes Grace	sem	like ( daniel , grace )
Daniel likes Lewis	sem	like ( daniel , lewis )
Daniel likes Margaret	sem	like ( daniel , margaret )
Daniel likes Oswald	sem	like ( daniel , oswald )
Daniel likes Patricia	sem	like ( daniel , patricia )
Daniel likes Rachael	sem	like ( daniel , rachael )
Daniel likes Samuel	sem	like ( daniel , samuel )
Daniel likes Ursula	sem	like ( daniel , ursula )
Daniel likes Victor	sem	like ( daniel , victor )
Daniel likes Xerxes	sem	like ( daniel , xerxes )
Daniel likes Yvette	sem	like ( daniel , yvettte )
Daniel dislikes Bob	sem	dislike ( daniel , bob )
Daniel dislikes Claire	sem	dislike ( daniel , claire )
Daniel dislikes Daniel	sem	dislike ( daniel , daniel )
Daniel dislikes Eliza	sem	dislike ( daniel , eliza )
Daniel dislikes Francis	sem	dislike ( daniel , francis )
Daniel dislikes Grace	sem	dislike ( daniel , grace )
Daniel dislikes Henry	sem	dislike ( daniel , henry )
Daniel dislikes John	sem	dislike ( daniel , john )
Daniel dislikes Katherine	sem	dislike ( daniel , katherine )
Daniel dislikes Lewis	sem	dislike ( daniel , lewis )
Daniel dislikes Margaret	sem	dislike ( daniel , margaret )
Daniel dislikes Neha	sem	dislike ( daniel , neha )
Daniel dislikes Patricia	sem	dislike ( daniel , patricia )
Daniel dislikes Quinn	sem	dislike ( daniel , quinn )
Daniel dislikes Rachael	sem	dislike ( daniel , rachael )
Daniel dislikes Samuel	sem	dislike ( daniel , samuel )
Daniel dislikes Tracy	sem	dislike ( daniel , tracy )
Daniel dislikes Ursula	sem	dislike ( daniel , ursula )
Daniel dislikes Victor	sem	dislike ( daniel , victor )
Daniel dislikes Winnifred	sem	dislike ( daniel , winnifred )
Daniel dislikes Xerxes	sem	dislike ( daniel , xerxes )
Daniel dislikes Zelda	sem	dislike ( daniel , zelda )
Daniel throws Claire	sem	throw ( daniel , claire )
Daniel throws Daniel	sem	throw ( daniel , daniel )
Daniel throws Francis	sem	throw ( daniel , francis )
Daniel throws Grace	sem	throw ( daniel , grace )
Daniel throws Henry	sem	throw ( daniel , henry )
Daniel throws Isla	sem	throw ( daniel , isla )
Daniel throws John	sem	throw ( daniel , john )
Daniel throws Katherine	sem	throw ( daniel , katherine )
Daniel throws Margaret	sem	throw ( daniel , margaret )
Daniel throws Neha	sem	throw ( daniel , neha )
Daniel throws Oswald	sem	throw ( daniel , oswald )
Daniel throws Quinn	sem	throw ( daniel , quinn )
Daniel throws Samuel	sem	throw ( daniel , samuel )
Daniel throws Victor	sem	throw ( daniel , victor )
Daniel throws Xerxes	sem	throw ( daniel , xerxes )
Daniel throws Yvette	sem	throw ( daniel , yvettte )
Daniel throws Zelda	sem	throw ( daniel , zelda )
Daniel notices Bob	sem	notice ( daniel , bob )
Daniel notices Claire	sem	notice ( daniel , claire )
Daniel notices Eliza	sem	notice ( daniel , eliza )
Daniel notices Francis	sem	notice ( daniel , francis )
Daniel notices Grace	sem	notice ( daniel , grace )
Daniel notices Henry	sem	notice ( daniel , henry )
Daniel notices Isla	sem	notice ( daniel , isla )
Daniel notices John	sem	notice ( daniel , john )
Daniel notices Katherine	sem	notice ( daniel , katherine )
Daniel notices Lewis	sem	notice ( daniel , lewis )
Daniel notices Margaret	sem	notice ( daniel , margaret )
Daniel notices Neha	sem	notice ( daniel , neha )
Daniel notices Oswald	sem	notice ( daniel , oswald )
Daniel notices Patricia	sem	notice ( daniel , patricia )
Daniel notices Rachael	sem	notice ( daniel , rachael )
Daniel notices Samuel	sem	notice ( daniel , samuel )
Daniel notices Tracy	sem	notice ( daniel , tracy )
Daniel notices Victor	sem	notice ( daniel , victor )
Daniel notices Winnifred	sem	notice ( daniel , winnifred )
Daniel notices Xerxes	sem	notice ( daniel , xerxes )
Daniel notices Yvette	sem	notice ( daniel , yvettte )
Daniel notices Zelda	sem	notice ( daniel , zelda )
Daniel knows Bob	sem	know ( daniel , bob )
Daniel knows Claire	sem	know ( daniel , claire )
Daniel knows Daniel	sem	know ( daniel , daniel )
Daniel knows Eliza	sem	know ( daniel , eliza )
Daniel knows Francis	sem	know ( daniel , francis )
Daniel knows Grace	sem	know ( daniel , grace )
Daniel knows Henry	sem	know ( daniel , henry )
Daniel knows Isla	sem	know ( daniel , isla )
Daniel knows John	sem	know ( daniel , john )
Daniel knows Katherine	sem	know ( daniel , katherine )
Daniel knows Lewis	sem	know ( daniel , lewis )
Daniel knows Margaret	sem	know ( daniel , margaret )
Daniel knows Neha	sem	know ( daniel , neha )
Daniel knows Patricia	sem	know ( daniel , patricia )
Daniel knows Quinn	sem	know ( daniel , quinn )
Daniel knows Rachael	sem	know ( daniel , rachael )
Daniel knows Samuel	sem	know ( daniel , samuel )
Daniel knows Tracy	sem	know ( daniel , tracy )
Daniel knows Ursula	sem	know ( daniel , ursula )
Daniel knows Victor	sem	know ( daniel , victor )
Daniel knows Winnifred	sem	know ( daniel , winnifred )
Daniel knows Xerxes	sem	know ( daniel , xerxes )
Daniel knows Zelda	sem	know ( daniel , zelda )
Daniel sees himself	sem	see ( daniel , daniel )
Daniel meets himself	sem	meet ( daniel , daniel )
Daniel throws himself	sem	throw ( daniel , daniel )
Daniel knows himself	sem	know ( daniel , daniel )
Eliza walks	sem	walk ( eliza )
Eliza sleeps	sem	sleep ( eliza )
Eliza runs	sem	run ( eliza )
Eliza sings	sem	sing ( eliza )
Eliza dances	sem	dance ( eliza )
Eliza flies	sem	fly ( eliza )
Eliza slumbers	sem	slumber ( eliza )
Eliza sees Bob	sem	see ( eliza , bob )
Eliza sees Claire	sem	see ( eliza , claire )
Eliza sees Daniel	sem	see ( eliza , daniel )
Eliza sees Eliza	sem	see ( eliza , eliza )
Eliza sees Grace	sem	see ( eliza , grace )
Eliza sees Henry	sem	see ( eliza , henry )
Eliza sees Isla	sem	see ( eliza , isla )
Eliza sees John	sem	see ( eliza , john )
Eliza sees Katherine	sem	see ( eliza , katherine )
Eliza sees Lewis	sem	see ( eliza , lewis )
Eliza sees Margaret	sem	see ( eliza , margaret )
Eliza sees Neha	sem	see ( eliza , neha )
Eliza sees Oswald	sem	see ( eliza , oswald )
Eliza sees Patricia	sem	see ( eliza , patricia )
Eliza sees Quinn	sem	see ( eliza , quinn )
Eliza sees Rachael	sem	see ( eliza , rachael )
Eliza sees Samuel	sem	see ( eliza , samuel )
Eliza sees Ursula	sem	see ( eliza , ursula )
Eliza sees Winnifred	sem	see ( eliza , winnifred )
Eliza sees Xerxes	sem	see ( eliza , xerxes )
Eliza meets Bob	sem	meet ( eliza , bob )
Eliza meets Daniel	sem	meet ( eliza , daniel )
Eliza meets Eliza	sem	meet ( eliza , eliza )
Eliza meets Grace	sem	meet ( eliza , grace )
Eliza meets Henry	sem	meet ( eliza , henry )
Eliza meets John	sem	meet ( eliza , john )
Eliza meets Katherine	sem	meet ( eliza , katherine )
Eliza meets Lewis	sem	meet ( eliza , lewis )
Eliza meets Margaret	sem	meet ( eliza , margaret )
Eliza meets Patricia	sem	meet ( eliza , patricia )
Eliza meets Quinn	sem	meet ( eliza , quinn )
Eliza meets Rachael	sem	meet ( eliza , rachael )
Eliza meets Tracy	sem	meet ( eliza , tracy )
Eliza meets Ursula	sem	meet ( eliza , ursula )
Eliza meets Winnifred	sem	meet ( eliza , winnifred )
Eliza meets Xerxes	sem	meet ( eliza , xerxes )
Eliza meets Yvette	sem	meet ( eliza , yvettte )
Eliza meets Zelda	sem	meet ( eliza , zelda )
Eliza likes Bob	sem	like ( eliza , bob )
Eliza likes Eliza	sem	like ( eliza , eliza )
Eliza likes Francis	sem	like ( eliza , francis )
Eliza likes Grace	sem	like ( eliza , grace )
Eliza likes John	sem	like ( eliza , john )
Eliza likes Katherine	sem	like ( eliza , katherine )
Eliza likes Lewis	sem	like ( eliza , lewis )
Eliza likes Margaret	sem	like ( eliza , margaret )
Eliza likes Neha	sem	like ( eliza , neha )
Eliza likes Oswald	sem	like ( eliza , oswald )
Eliza likes Patricia	sem	like ( eliza , patricia )
Eliza likes Quinn	sem	like ( eliza , quinn )
Eliza likes Rachael	sem	like ( eliza , rachael )
Eliza likes Samuel	sem	like ( eliza , samuel )
Eliza likes Ursula	sem	like ( eliza , ursula )
Eliza likes Victor	sem	like ( eliza , victor )
Eliza likes Winnifred	sem	like ( eliza , winnifred )
Eliza likes Zelda	sem	like ( eliza , zelda )
Eliza dislikes Bob	sem	dislike ( eliza , bob )
Eliza dislikes Claire	sem	dislike ( eliza , claire )
Eliza dislikes Daniel	sem	dislike ( eliza , daniel )
Eliza dislikes Grace	sem	dislike ( eliza , grace )
Eliza dislikes Henry	sem	dislike ( eliza , henry )
Eliza dislikes Isla	sem	dislike ( eliza , isla )
Eliza dislikes John	sem	dislike ( eliza , john )
Eliza dislikes Katherine	sem	dislike ( eliza , katherine )
Eliza dislikes Lewis	sem	dislike ( eliza , lewis )
Eliza dislikes Margaret	sem	dislike ( eliza , margaret )
Eliza dislikes Neha	sem	dislike ( eliza , neha )
Eliza dislikes Oswald	sem	dislike ( eliza , oswald )
Eliza dislikes Quinn	sem	dislike ( eliza , quinn )
Eliza dislikes Rachael	sem	dislike ( eliza , rachael )
Eliza dislikes Samuel	sem	dislike ( eliza , samuel )
Eliza dislikes Tracy	sem	dislike ( eliza , tracy )
Eliza dislikes Ursula	sem	dislike ( eliza , ursula )
Eliza dislikes Victor	sem	dislike ( eliza , victor )
Eliza dislikes Winnifred	sem	dislike ( eliza , winnifred )
Eliza dislikes Yvette	sem	dislike ( eliza , yvettte )
Eliza dislikes Zelda	sem	dislike ( eliza , zelda )
Eliza throws Daniel	sem	throw ( eliza , daniel )
Eliza throws Francis	sem	throw ( eliza , francis )
Eliza throws Henry	sem	throw ( eliza , henry )
Eliza throws Isla	sem	throw ( eliza , isla )
Eliza throws John	sem	throw ( eliza , john )
Eliza throws Katherine	sem	throw ( eliza , katherine )
Eliza throws Margaret	sem	throw ( eliza , margaret )
Eliza throws Oswald	sem	throw ( eliza , oswald )
Eliza throws Patricia	sem	throw ( eliza , patricia )
Eliza throws Quinn	sem	throw ( eliza , quinn )
Eliza throws Rachael	sem	throw ( eliza , rachael )
Eliza throws Samuel	sem	throw ( eliza , samuel )
Eliza throws Tracy	sem	throw ( eliza , tracy )
Eliza throws Ursula	sem	throw ( eliza , ursula )
Eliza throws Victor	sem	throw ( eliza , victor )
Eliza throws Winnifred	sem	throw ( eliza , winnifred )
Eliza throws Xerxes	sem	throw ( eliza , xerxes )
Eliza throws Yvette	sem	throw ( eliza , yvettte )
Eliza notices Claire	sem	notice ( eliza , claire )
Eliza notices Daniel	sem	notice ( eliza , daniel )
Eliza notices Eliza	sem	notice ( eliza , eliza )
Eliza notices Francis	sem	notice ( eliza , francis )
Eliza notices Grace	sem	notice ( eliza , grace )
Eliza notices Isla	sem	notice ( eliza , isla )
Eliza notices John	sem	notice ( eliza , john )
Eliza notices Margaret	sem	notice ( eliza , margaret )
Eliza notices Neha	sem	notice ( eliza , neha )
Eliza notices Patricia	sem	notice ( eliza , patricia )
Eliza notices Quinn	sem	notice ( eliza , quinn )
Eliza notices Rachael	sem	notice ( eliza , rachael )
Eliza notices Samuel	sem	notice ( eliza , samuel )
Eliza notices Tracy	sem	notice ( eliza , tracy )
Eliza notices Ursula	sem	notice ( eliza , ursula )
Eliza notices Victor	sem	notice ( eliza , victor )
Eliza notices Winnifred	sem	notice ( eliza , winnifred )
Eliza notices Xerxes	sem	notice ( eliza , xerxes )
Eliza knows Claire	sem	know ( eliza , claire )
Eliza knows Daniel	sem	know ( eliza , daniel )
Eliza knows Eliza	sem	know ( eliza , eliza )
Eliza knows Francis	sem	know ( eliza , francis )
Eliza knows Grace	sem	know ( eliza , grace )
Eliza knows Henry	sem	know ( eliza , henry )
Eliza knows Katherine	sem	know ( eliza , katherine )
Eliza knows Lewis	sem	know ( eliza , lewis )
Eliza knows Margaret	sem	know ( eliza , margaret )
Eliza knows Patricia	sem	know ( eliza , patricia )
Eliza knows Quinn	sem	know ( eliza , quinn )
Eliza knows Rachael	sem	know ( eliza , rachael )
Eliza knows Tracy	sem	know ( eliza , tracy )
Eliza knows Ursula	sem	know ( eliza , ursula )
Eliza knows Xerxes	sem	know ( eliza , xerxes )
Eliza knows Yvette	sem	know ( eliza , yvettte )
Eliza knows Zelda	sem	know ( eliza , zelda )
Eliza likes herself	sem	like ( eliza , eliza )
Eliza throws herself	sem	throw ( eliza , eliza )
Eliza notices herself	sem	notice ( eliza , eliza )
Eliza knows herself	sem	know ( eliza , eliza )
Francis sleeps	sem	sleep ( francis )
Francis runs	sem	run ( francis )
Francis sings	sem	sing ( francis )
Francis dances	sem	dance ( francis )
Francis flies	sem	fly ( francis )
Francis slumbers	sem	slumber ( francis )
Francis sees Bob	sem	see ( francis , bob )
Francis sees Francis	sem	see ( francis , francis )
Francis sees Grace	sem	see ( francis , grace )
Francis sees Henry	sem	see ( francis , henry )
Francis sees Isla	sem	see ( francis , isla )
Francis sees Katherine	sem	see ( francis , katherine )
Francis sees Lewis	sem	see ( francis , lewis )
Francis sees Margaret	sem	see ( francis , margaret )
Francis sees Neha	sem	see ( francis , neha )
Francis sees Oswald	sem	see ( francis , oswald )
Francis sees Patricia	sem	see ( francis , patricia )
Francis sees Quinn	sem	see ( francis , quinn )
Francis sees Rachael	sem	see ( francis , rachael )
Francis sees Samuel	sem	see ( francis , samuel )
Francis sees Tracy	sem	see ( francis , tracy )
Francis sees Ursula	sem	see ( francis , ursula )
Francis sees Victor	sem	see ( francis , victor )
Francis sees Winnifred	sem	see ( francis , winnifred )
Francis sees Xerxes	sem	see ( francis , xerxes )
Francis sees Yvette	sem	see ( francis , yvettte )
Francis sees Zelda	sem	see ( francis , zelda )
Francis meets Bob	sem	meet ( francis , bob )
Francis meets Claire	sem	meet ( francis , claire )
Francis meets Daniel	sem	meet ( francis , daniel )
Francis meets Eliza	sem	meet ( francis , eliza )
Francis meets Francis	sem	meet ( francis , francis )
Francis meets Grace	sem	meet ( francis , grace )
Francis meets Isla	sem	meet ( francis , isla )
Francis meets Katherine	sem	meet ( francis , katherine )
Francis meets Lewis	sem	meet ( francis , lewis )
Francis meets Margaret	sem	meet ( francis , margaret )
Francis meets Neha	sem	meet ( francis , neha )
Francis meets Oswald	sem	meet ( francis , oswald )
Francis meets Quinn	sem	meet ( francis , quinn )
Francis meets Rachael	sem	meet ( francis , rachael )
Francis meets Tracy	sem	meet ( francis , tracy )
Francis meets Ursula	sem	meet ( francis , ursula )
Francis meets Victor	sem	meet ( francis , victor )
Francis meets Winnifred	sem	meet ( francis , winnifred )
Francis meets Xerxes	sem	meet ( francis , xerxes )
Francis meets Yvette	sem	meet ( francis , yvettte )
Francis meets Zelda	sem	meet ( francis , zelda )
Francis likes Bob	sem	like ( francis , bob )
Francis likes Claire	sem	like ( francis , claire )
Francis likes Daniel	sem	like ( francis , daniel )
Francis likes Francis	sem	like ( francis , francis )
Francis likes Grace	sem	like ( francis , grace )
Francis likes Henry	sem	like ( francis , henry )
Francis likes John	sem	like ( francis , john )
Francis likes Lewis	sem	like ( francis , lewis )
Francis likes Margaret	sem	like ( francis , margaret )
Francis likes Neha	sem	like ( francis , neha )
Francis likes Patricia	sem	like ( francis , patricia )
Francis likes Rachael	sem	like ( francis , rachael )
Francis likes Samuel	sem	like ( francis , samuel )
Francis likes Tracy	sem	like ( francis , tracy )
Francis likes Ursula	sem	like ( francis , ursula )
Francis likes Victor	sem	like ( francis , victor )
Francis likes Winnifred	sem	like ( francis , winnifred )
Francis likes Yvette	sem	like ( francis , yvettte )
Francis likes Zelda	sem	like ( francis , zelda )
Francis dislikes Bob	sem	dislike ( francis , bob )
Francis dislikes Claire	sem	dislike ( francis , claire )
Francis dislikes Daniel	sem	dislike ( francis , daniel )
Francis dislikes Francis	sem	dislike ( francis , francis )
Francis dislikes Grace	sem	dislike ( francis , grace )
Francis dislikes Henry	sem	dislike ( francis , henry )
Francis dislikes Isla	sem	dislike ( francis , isla )
Francis dislikes John	sem	dislike ( francis , john )
Francis dislikes Katherine	sem	dislike ( francis , katherine )
Francis dislikes Lewis	sem	dislike ( francis , lewis )
Francis dislikes Margaret	sem	dislike ( francis , margaret )
Francis dislikes Neha	sem	dislike ( francis , neha )
Francis dislikes Patricia	sem	dislike ( francis , patricia )
Francis dislikes Rachael	sem	dislike ( francis , rachael )
Francis dislikes Samuel	sem	dislike ( francis , samuel )
Francis dislikes Tracy	sem	dislike ( francis , tracy )
Francis dislikes Ursula	sem	dislike ( francis , ursula )
Francis dislikes Victor	sem	dislike ( francis , victor )
Francis dislikes Winnifred	sem	dislike ( francis , winnifred )
Francis dislikes Xerxes	sem	dislike ( francis , xerxes )
Francis dislikes Yvette	sem	dislike ( francis , yvettte )
Francis dislikes Zelda	sem	dislike ( francis , zelda )
Francis throws Bob	sem	throw ( francis , bob )
Francis throws Claire	sem	throw ( francis , claire )
Francis throws Daniel	sem	throw ( francis , daniel )
Francis throws Eliza	sem	throw ( francis , eliza )
Francis throws Francis	sem	throw ( francis , francis )
Francis throws Grace	sem	throw ( francis , grace )
Francis throws Henry	sem	throw ( francis , henry )
Francis throws Isla	sem	throw ( francis , isla )
Francis throws John	sem	throw ( francis , john )
Francis throws Katherine	sem	throw ( francis , katherine )
Francis throws Lewis	sem	throw ( francis , lewis )
Francis throws Oswald	sem	throw ( francis , oswald )
Francis throws Patricia	sem	throw ( francis , patricia )
Francis throws Quinn	sem	throw ( francis , quinn )
Francis throws Rachael	sem	throw ( francis , rachael )
Francis throws Samuel	sem	throw ( francis , samuel )
Francis throws Tracy	sem	throw ( francis , tracy )
Francis throws Victor	sem	throw ( francis , victor )
Francis throws Winnifred	sem	throw ( francis , winnifred )
Francis throws Xerxes	sem	throw ( francis , xerxes )
Francis throws Yvette	sem	throw ( francis , yvettte )
Francis notices Claire	sem	notice ( francis , claire )
Francis notices Francis	sem	notice ( francis , francis )
Francis notices Grace	sem	notice ( francis , grace )
Francis notices Henry	sem	notice ( francis , henry )
Francis notices Katherine	sem	notice ( francis , katherine )
Francis notices Neha	sem	notice ( francis , neha )
Francis notices Oswald	sem	notice ( francis , oswald )
Francis notices Quinn	sem	notice ( francis , quinn )
Francis notices Rachael	sem	notice ( francis , rachael )
Francis notices Tracy	sem	notice ( francis , tracy )
Francis notices Ursula	sem	notice ( francis , ursula )
Francis notices Victor	sem	notice ( francis , victor )
Francis notices Winnifred	sem	notice ( francis , winnifred )
Francis notices Xerxes	sem	notice ( francis , xerxes )
Francis notices Zelda	sem	notice ( francis , zelda )
Francis knows Bob	sem	know ( francis , bob )
Francis knows Claire	sem	know ( francis , claire )
Francis knows Daniel	sem	know ( francis , daniel )
Francis knows Eliza	sem	know ( francis , eliza )
Francis knows Francis	sem	know ( francis , francis )
Francis knows Grace	sem	know ( francis , grace )
Francis knows Isla	sem	know ( francis , isla )
Francis knows John	sem	know ( francis , john )
Francis knows Katherine	sem	know ( francis , katherine )
Francis knows Lewis	sem	know ( francis , lewis )
Francis knows Oswald	sem	know ( francis , oswald )
Francis knows Patricia	sem	know ( francis , patricia )
Francis knows Quinn	sem	know ( francis , quinn )
Francis knows Rachael	sem	know ( francis , rachael )
Francis knows Samuel	sem	know ( francis , samuel )
Francis knows Ursula	sem	know ( francis , ursula )
Francis knows Victor	sem	know ( francis , victor )
Francis knows Winnifred	sem	know ( francis , winnifred )
Francis knows Yvette	sem	know ( francis , yvettte )
Francis sees himself	sem	see ( francis , francis )
Francis meets himself	sem	meet ( francis , francis )
Francis likes himself	sem	like ( francis , francis )
Francis dislikes himself	sem	dislike ( francis , francis )
Francis notices himself	sem	notice ( francis , francis )
Francis knows himself	sem	know ( francis , francis )
Grace walks	sem	walk ( grace )
Grace sleeps	sem	sleep ( grace )
Grace eats	sem	eat ( grace )
Grace runs	sem	run ( grace )
Grace sings	sem	sing ( grace )
Grace dances	sem	dance ( grace )
Grace flies	sem	fly ( grace )
Grace slumbers	sem	slumber ( grace )
Grace sees Bob	sem	see ( grace , bob )
Grace sees Daniel	sem	see ( grace , daniel )
Grace sees Eliza	sem	see ( grace , eliza )
Grace sees Francis	sem	see ( grace , francis )
Grace sees Isla	sem	see ( grace , isla )
Grace sees John	sem	see ( grace , john )
Grace sees Katherine	sem	see ( grace , katherine )
Grace sees Lewis	sem	see ( grace , lewis )
Grace sees Margaret	sem	see ( grace , margaret )
Grace sees Neha	sem	see ( grace , neha )
Grace sees Oswald	sem	see ( grace , oswald )
Grace sees Quinn	sem	see ( grace , quinn )
Grace sees Rachael	sem	see ( grace , rachael )
Grace sees Samuel	sem	see ( grace , samuel )
Grace sees Tracy	sem	see ( grace , tracy )
Grace sees Ursula	sem	see ( grace , ursula )
Grace sees Victor	sem	see ( grace , victor )
Grace sees Yvette	sem	see ( grace , yvettte )
Grace sees Zelda	sem	see ( grace , zelda )
Grace meets Bob	sem	meet ( grace , bob )
Grace meets Claire	sem	meet ( grace , claire )
Grace meets Daniel	sem	meet ( grace , daniel )
Grace meets Henry	sem	meet ( grace , henry )
Grace meets Isla	sem	meet ( grace , isla )
Grace meets John	sem	meet ( grace , john )
Grace meets Katherine	sem	meet ( grace , katherine )
Grace meets Lewis	sem	meet ( grace , lewis )
Grace meets Margaret	sem	meet ( grace , margaret )
Grace meets Neha	sem	meet ( grace , neha )
Grace meets Patricia	sem	meet ( grace , patricia )
Grace meets Quinn	sem	meet ( grace , quinn )
Grace meets Rachael	sem	meet ( grace , rachael )
Grace meets Samuel	sem	meet ( grace , samuel )
Grace meets Tracy	sem	meet ( grace , tracy )
Grace meets Ursula	sem	meet ( grace , ursula )
Grace meets Winnifred	sem	meet ( grace , winnifred )
Grace meets Zelda	sem	meet ( grace , zelda )
Grace likes Bob	sem	like ( grace , bob )
Grace likes Daniel	sem	like ( grace , daniel )
Grace likes Eliza	sem	like ( grace , eliza )
Grace likes Francis	sem	like ( grace , francis )
Grace likes Grace	sem	like ( grace , grace )
Grace likes Isla	sem	like ( grace , isla )
Grace likes Lewis	sem	like ( grace , lewis )
Grace likes Margaret	sem	like ( grace , margaret )
Grace likes Neha	sem	like ( grace , neha )
Grace likes Oswald	sem	like ( grace , oswald )
Grace likes Patricia	sem	like ( grace , patricia )
Grace likes Quinn	sem	like ( grace , quinn )
Grace likes Rachael	sem	like ( grace , rachael )
Grace likes Samuel	sem	like ( grace , samuel )
Grace likes Tracy	sem	like ( grace , tracy )
Grace likes Ursula	sem	like ( grace , ursula )
Grace likes Victor	sem	like ( grace , victor )
Grace likes Winnifred	sem	like ( grace , winnifred )
Grace likes Zelda	sem	like ( grace , zelda )
Grace dislikes Bob	sem	dislike ( grace , bob )
Grace dislikes Claire	sem	dislike ( grace , claire )
Grace dislikes Daniel	sem	dislike ( grace , daniel )
Grace dislikes Eliza	sem	dislike ( grace , eliza )
Grace dislikes Grace	sem	dislike ( grace , grace )
Grace dislikes Henry	sem	dislike ( grace , henry )
Grace dislikes Isla	sem	dislike ( grace , isla )
Grace dislikes John	sem	dislike ( grace , john )
Grace dislikes Katherine	sem	dislike ( grace , katherine )
Grace dislikes Lewis	sem	dislike ( grace , lewis )
Grace dislikes Margaret	sem	dislike ( grace , margaret )
Grace dislikes Neha	sem	dislike ( grace , neha )
Grace dislikes Oswald	sem	dislike ( grace , oswald )
Grace dislikes Quinn	sem	dislike ( grace , quinn )
Grace dislikes Rachael	sem	dislike ( grace , rachael )
Grace dislikes Samuel	sem	dislike ( grace , samuel )
Grace dislikes Tracy	sem	dislike ( grace , tracy )
Grace dislikes Ursula	sem	dislike ( grace , ursula )
Grace dislikes Victor	sem	dislike ( grace , victor )
Grace dislikes Winnifred	sem	dislike ( grace , winnifred )
Grace dislikes Xerxes	sem	dislike ( grace , xerxes )
Grace dislikes Yvette	sem	dislike ( grace , yvettte )
Grace dislikes Zelda	sem	dislike ( grace , zelda )
Grace throws Bob	sem	throw ( grace , bob )
Grace throws Daniel	sem	throw ( grace , daniel )
Grace throws Eliza	sem	throw ( grace , eliza )
Grace throws Francis	sem	throw ( grace , francis )
Grace throws Henry	sem	throw ( grace , henry )
Grace throws John	sem	throw ( grace , john )
Grace throws Katherine	sem	throw ( grace , katherine )
Grace throws Lewis	sem	throw ( grace , lewis )
Grace throws Margaret	sem	throw ( grace , margaret )
Grace throws Oswald	sem	throw ( grace , oswald )
Grace throws Quinn	sem	throw ( grace , quinn )
Grace throws Rachael	sem	throw ( grace , rachael )
Grace throws Samuel	sem	throw ( grace , samuel )
Grace throws Tracy	sem	throw ( grace , tracy )
Grace throws Ursula	sem	throw ( grace , ursula )
Grace throws Victor	sem	throw ( grace , victor )
Grace throws Xerxes	sem	throw ( grace , xerxes )
Grace throws Yvette	sem	throw ( grace , yvettte )
Grace throws Zelda	sem	throw ( grace , zelda )
Grace notices Bob	sem	notice ( grace , bob )
Grace notices Claire	sem	notice ( grace , claire )
Grace notices Francis	sem	notice ( grace , francis )
Grace notices Grace	sem	notice ( grace , grace )
Grace notices Henry	sem	notice ( grace , henry )
Grace notices John	sem	notice ( grace , john )
Grace notices Katherine	sem	notice ( grace , katherine )
Grace notices Lewis	sem	notice ( grace , lewis )
Grace notices Margaret	sem	notice ( grace , margaret )
Grace notices Neha	sem	notice ( grace , neha )
Grace notices Oswald	sem	notice ( grace , oswald )
Grace notices Patricia	sem	notice ( grace , patricia )
Grace notices Quinn	sem	notice ( grace , quinn )
Grace notices Rachael	sem	notice ( grace , rachael )
Grace notices Samuel	sem	notice ( grace , samuel )
Grace notices Tracy	sem	notice ( grace , tracy )
Grace notices Ursula	sem	notice ( grace , ursula )
Grace notices Winnifred	sem	notice ( grace , winnifred )
Grace notices Xerxes	sem	notice ( grace , xerxes )
Grace notices Zelda	sem	notice ( grace , zelda )
Grace knows Bob	sem	know ( grace , bob )
Grace knows Claire	sem	know ( grace , claire )
Grace knows Daniel	sem	know ( grace , daniel )
Grace knows Eliza	sem	know ( grace , eliza )
Grace knows Francis	sem	know ( grace , francis )
Grace knows Grace	sem	know ( grace , grace )
Grace knows Henry	sem	know ( grace , henry )
Grace knows Isla	sem	know ( grace , isla )
Grace knows John	sem	know ( grace , john )
Grace knows Katherine	sem	know ( grace , katherine )
Grace knows Lewis	sem	know ( grace , lewis )
Grace knows Margaret	sem	know ( grace , margaret )
Grace knows Oswald	sem	know ( grace , oswald )
Grace knows Patricia	sem	know ( grace , patricia )
Grace knows Quinn	sem	know ( grace , quinn )
Grace knows Rachael	sem	know ( grace , rachael )
Grace knows Samuel	sem	know ( grace , samuel )
Grace knows Tracy	sem	know ( grace , tracy )
Grace knows Ursula	sem	know ( grace , ursula )
Grace knows Victor	sem	know ( grace , victor )
Grace knows Winnifred	sem	know ( grace , winnifred )
Grace knows Xerxes	sem	know ( grace , xerxes )
Grace knows Yvette	sem	know ( grace , yvettte )
Grace knows Zelda	sem	know ( grace , zelda )
Grace sees herself	sem	see ( grace , grace )
Grace meets herself	sem	meet ( grace , grace )
Grace likes herself	sem	like ( grace , grace )
Grace dislikes herself	sem	dislike ( grace , grace )
Grace throws herself	sem	throw ( grace , grace )
Grace notices herself	sem	notice ( grace , grace )
Grace knows herself	sem	know ( grace , grace )
Henry eats	sem	eat ( henry )
Henry runs	sem	run ( henry )
Henry sings	sem	sing ( henry )
Henry dances	sem	dance ( henry )
Henry flies	sem	fly ( henry )
Henry sees Daniel	sem	see ( henry , daniel )
Henry sees Eliza	sem	see ( henry , eliza )
Henry sees Francis	sem	see ( henry , francis )
Henry sees Grace	sem	see ( henry , grace )
Henry sees John	sem	see ( henry , john )
Henry sees Katherine	sem	see ( henry , katherine )
Henry sees Lewis	sem	see ( henry , lewis )
Henry sees Neha	sem	see ( henry , neha )
Henry sees Oswald	sem	see ( henry , oswald )
Henry sees Patricia	sem	see ( henry , patricia )
Henry sees Rachael	sem	see ( henry , rachael )
Henry sees Samuel	sem	see ( henry , samuel )
Henry sees Tracy	sem	see ( henry , tracy )
Henry sees Ursula	sem	see ( henry , ursula )
Henry sees Xerxes	sem	see ( henry , xerxes )
Henry sees Yvette	sem	see ( henry , yvettte )
Henry sees Zelda	sem	see ( henry , zelda )
Henry meets Bob	sem	meet ( henry , bob )
Henry meets Claire	sem	meet ( henry , claire )
Henry meets Daniel	sem	meet ( henry , daniel )
Henry meets Francis	sem	meet ( henry , francis )
Henry meets Grace	sem	meet ( henry , grace )
Henry meets Isla	sem	meet ( henry , isla )
Henry meets Katherine	sem	meet ( henry , katherine )
Henry meets Lewis	sem	meet ( henry , lewis )
Henry meets Margaret	sem	meet ( henry , margaret )
Henry meets Neha	sem	meet ( henry , neha )
Henry meets Oswald	sem	meet ( henry , oswald )
Henry meets Patricia	sem	meet ( henry , patricia )
Henry meets Rachael	sem	meet ( henry , rachael )
Henry meets Samuel	sem	meet ( henry , samuel )
Henry meets Tracy	sem	meet ( henry , tracy )
Henry meets Yvette	sem	meet ( henry , yvettte )
Henry meets Zelda	sem	meet ( henry , zelda )
Henry likes Bob	sem	like ( henry , bob )
Henry likes Claire	sem	like ( henry , claire )
Henry likes Eliza	sem	like ( henry , eliza )
Henry likes Francis	sem	like ( henry , francis )
Henry likes Grace	sem	like ( henry , grace )
Henry likes Henry	sem	like ( henry , henry )
Henry likes Katherine	sem	like ( henry , katherine )
Henry likes Lewis	sem	like ( henry , lewis )
Henry likes Neha	sem	like ( henry , neha )
Henry likes Oswald	sem	like ( henry , oswald )
Henry likes Quinn	sem	like ( henry , quinn )
Henry likes Rachael	sem	like ( henry , rachael )
Henry likes Tracy	sem	like ( henry , tracy )
Henry likes Ursula	sem	like ( henry , ursula )
Henry likes Victor	sem	like ( henry , victor )
Henry likes Winnifred	sem	like ( henry , winnifred )
Henry likes Xerxes	sem	like ( henry , xerxes )
Henry likes Yvette	sem	like ( henry , yvettte )
Henry likes Zelda	sem	like ( henry , zelda )
Henry dislikes Bob	sem	dislike ( henry , bob )
Henry dislikes Claire	sem	dislike ( henry , claire )
Henry dislikes Eliza	sem	dislike ( henry , eliza )
Henry dislikes Francis	sem	dislike ( henry , francis )
Henry dislikes Grace	sem	dislike ( henry , grace )
Henry dislikes Henry	sem	dislike ( henry , henry )
Henry dislikes Isla	sem	dislike ( henry , isla )
Henry dislikes Katherine	sem	dislike ( henry , katherine )
Henry dislikes Lewis	sem	dislike ( henry , lewis )
Henry dislikes Margaret	sem	dislike ( henry , margaret )
Henry dislikes Neha	sem	dislike ( henry , neha )
Henry dislikes Oswald	sem	dislike ( henry , oswald )
Henry dislikes Patricia	sem	dislike ( henry , patricia )
Henry dislikes Quinn	sem	dislike ( henry , quinn )
Henry dislikes Rachael	sem	dislike ( henry , rachael )
Henry dislikes Samuel	sem	dislike ( henry , samuel )
Henry dislikes Tracy	sem	dislike ( henry , tracy )
Henry dislikes Ursula	sem	dislike ( henry , ursula )
Henry dislikes Victor	sem	dislike ( henry , victor )
Henry dislikes Winnifred	sem	dislike ( henry , winnifred )
Henry dislikes Xerxes	sem	dislike ( henry , xerxes )
Henry dislikes Yvette	sem	dislike ( henry , yvettte )
Henry dislikes Zelda	sem	dislike ( henry , zelda )
Henry throws Bob	sem	throw ( henry , bob )
Henry throws Claire	sem	throw ( henry , claire )
Henry throws Daniel	sem	throw ( henry , daniel )
Henry throws Eliza	sem	throw ( henry , eliza )
Henry throws Francis	sem	throw ( henry , francis )
Henry throws Grace	sem	throw ( henry , grace )
Henry throws Henry	sem	throw ( henry , henry )
Henry throws John	sem	throw ( henry , john )
Henry throws Katherine	sem	throw ( henry , katherine )
Henry throws Neha	sem	throw ( henry , neha )
Henry throws Oswald	sem	throw ( henry , oswald )
Henry throws Quinn	sem	throw ( henry , quinn )
Henry throws Samuel	sem	throw ( henry , samuel )
Henry throws Ursula	sem	throw ( henry , ursula )
Henry throws Victor	sem	throw ( henry , victor )
Henry throws Winnifred	sem	throw ( henry , winnifred )
Henry throws Xerxes	sem	throw ( henry , xerxes )
Henry throws Zelda	sem	throw ( henry , zelda )
Henry notices Bob	sem	notice ( henry , bob )
Henry notices Claire	sem	notice ( henry , claire )
Henry notices Daniel	sem	notice ( henry , daniel )
Henry notices Francis	sem	notice ( henry , francis )
Henry notices Grace	sem	notice ( henry , grace )
Henry notices Henry	sem	notice ( henry , henry )
Henry notices Isla	sem	notice ( henry , isla )
Henry notices John	sem	notice ( henry , john )
Henry notices Katherine	sem	notice ( henry , katherine )
Henry notices Lewis	sem	notice ( henry , lewis )
Henry notices Neha	sem	notice ( henry , neha )
Henry notices Oswald	sem	notice ( henry , oswald )
Henry notices Patricia	sem	notice ( henry , patricia )
Henry notices Quinn	sem	notice ( henry , quinn )
Henry notices Tracy	sem	notice ( henry , tracy )
Henry notices Ursula	sem	notice ( henry , ursula )
Henry notices Victor	sem	notice ( henry , victor )
Henry notices Winnifred	sem	notice ( henry , winnifred )
Henry notices Xerxes	sem	notice ( henry , xerxes )
Henry notices Yvette	sem	notice ( henry , yvettte )
Henry notices Zelda	sem	notice ( henry , zelda )
Henry knows Bob	sem	know ( henry , bob )
Henry knows Claire	sem	know ( henry , claire )
Henry knows Daniel	sem	know ( henry , daniel )
Henry knows Eliza	sem	know ( henry , eliza )
Henry knows Francis	sem	know ( henry , francis )
Henry knows Grace	sem	know ( henry , grace )
Henry knows Henry	sem	know ( henry , henry )
Henry knows Isla	sem	know ( henry , isla )
Henry knows John	sem	know ( henry , john )
Henry knows Katherine	sem	know ( henry , katherine )
Henry knows Lewis	sem	know ( henry , lewis )
Henry knows Margaret	sem	know ( henry , margaret )
Henry knows Oswald	sem	know ( henry , oswald )
Henry knows Patricia	sem	know ( henry , patricia )
Henry knows Quinn	sem	know ( henry , quinn )
Henry knows Rachael	sem	know ( henry , rachael )
Henry knows Samuel	sem	know ( henry , samuel )
Henry knows Tracy	sem	know ( henry , tracy )
Henry knows Ursula	sem	know ( henry , ursula )
Henry knows Victor	sem	know ( henry , victor )
Henry knows Xerxes	sem	know ( henry , xerxes )
Henry knows Yvette	sem	know ( henry , yvettte )
Henry knows Zelda	sem	know ( henry , zelda )
Henry sees himself	sem	see ( henry , henry )
Henry meets himself	sem	meet ( henry , henry )
Henry likes himself	sem	like ( henry , henry )
Henry dislikes himself	sem	dislike ( henry , henry )
Henry throws himself	sem	throw ( henry , henry )
Henry notices himself	sem	notice ( henry , henry )
Henry knows himself	sem	know ( henry , henry )
Isla walks	sem	walk ( isla )
Isla sleeps	sem	sleep ( isla )
Isla eats	sem	eat ( isla )
Isla runs	sem	run ( isla )
Isla dances	sem	dance ( isla )
Isla flies	sem	fly ( isla )
Isla slumbers	sem	slumber ( isla )
Isla sees Bob	sem	see ( isla , bob )
Isla sees Claire	sem	see ( isla , claire )
Isla sees Daniel	sem	see ( isla , daniel )
Isla sees Eliza	sem	see ( isla , eliza )
Isla sees Francis	sem	see ( isla , francis )
Isla sees Grace	sem	see ( isla , grace )
Isla sees Henry	sem	see ( isla , henry )
Isla sees Isla	sem	see ( isla , isla )
Isla sees John	sem	see ( isla , john )
Isla sees Lewis	sem	see ( isla , lewis )
Isla sees Margaret	sem	see ( isla , margaret )
Isla sees Neha	sem	see ( isla , neha )
Isla sees Oswald	sem	see ( isla , oswald )
Isla sees Patricia	sem	see ( isla , patricia )
Isla sees Quinn	sem	see ( isla , quinn )
Isla sees Rachael	sem	see ( isla , rachael )
Isla sees Tracy	sem	see ( isla , tracy )
Isla sees Ursula	sem	see ( isla , ursula )
Isla sees Victor	sem	see ( isla , victor )
Isla sees Winnifred	sem	see ( isla , winnifred )
Isla sees Xerxes	sem	see ( isla , xerxes )
Isla sees Yvette	sem	see ( isla , yvettte )
Isla sees Zelda	sem	see ( isla , zelda )
Isla meets Bob	sem	meet ( isla , bob )
Isla meets Claire	sem	meet ( isla , claire )
Isla meets Francis	sem	meet ( isla , francis )
Isla meets Grace	sem	meet ( isla , grace )
Isla meets Henry	sem	meet ( isla , henry )
Isla meets Katherine	sem	meet ( isla , katherine )
Isla meets Margaret	sem	meet ( isla , margaret )
Isla meets Neha	sem	meet ( isla , neha )
Isla meets Quinn	sem	meet ( isla , quinn )
Isla meets Rachael	sem	meet ( isla , rachael )
Isla meets Samuel	sem	meet ( isla , samuel )
Isla meets Tracy	sem	meet ( isla , tracy )
Isla meets Ursula	sem	meet ( isla , ursula )
Isla meets Victor	sem	meet ( isla , victor )
Isla meets Xerxes	sem	meet ( isla , xerxes )
Isla meets Yvette	sem	meet ( isla , yvettte )
Isla meets Zelda	sem	meet ( isla , zelda )
Isla likes Bob	sem	like ( isla , bob )
Isla likes Claire	sem	like ( isla , claire )
Isla likes Daniel	sem	like ( isla , daniel )
Isla likes Eliza	sem	like ( isla , eliza )
Isla likes Francis	sem	like ( isla , francis )
Isla likes Grace	sem	like ( isla , grace )
Isla likes Henry	sem	like ( isla , henry )
Isla likes Isla	sem	like ( isla , isla )
Isla likes Lewis	sem	like ( isla , lewis )
Isla likes Neha	sem	like ( isla , neha )
Isla likes Oswald	sem	like ( isla , oswald )
Isla likes Patricia	sem	like ( isla , patricia )
Isla likes Quinn	sem	like ( isla , quinn )
Isla likes Samuel	sem	like ( isla , samuel )
Isla likes Tracy	sem	like ( isla , tracy )
Isla likes Ursula	sem	like ( isla , ursula )
Isla likes Victor	sem	like ( isla , victor )
Isla likes Winnifred	sem	like ( isla , winnifred )
Isla likes Xerxes	sem	like ( isla , xerxes )
Isla likes Yvette	sem	like ( isla , yvettte )
Isla dislikes Bob	sem	dislike ( isla , bob )
Isla dislikes Francis	sem	dislike ( isla , francis )
Isla dislikes Grace	sem	dislike ( isla , grace )
Isla dislikes Henry	sem	dislike ( isla , henry )
Isla dislikes Isla	sem	dislike ( isla , isla )
Isla dislikes John	sem	dislike ( isla , john )
Isla dislikes Katherine	sem	dislike ( isla , katherine )
Isla dislikes Lewis	sem	dislike ( isla , lewis )
Isla dislikes Margaret	sem	dislike ( isla , margaret )
Isla dislikes Oswald	sem	dislike ( isla , oswald )
Isla dislikes Patricia	sem	dislike ( isla , patricia )
Isla dislikes Quinn	sem	dislike ( isla , quinn )
Isla dislikes Rachael	sem	dislike ( isla , rachael )
Isla dislikes Samuel	sem	dislike ( isla , samuel )
Isla dislikes Tracy	sem	dislike ( isla , tracy )
Isla dislikes Ursula	sem	dislike ( isla , ursula )
Isla dislikes Victor	sem	dislike ( isla , victor )
Isla dislikes Winnifred	sem	dislike ( isla , winnifred )
Isla dislikes Xerxes	sem	dislike ( isla , xerxes )
Isla dislikes Yvette	sem	dislike ( isla , yvettte )
Isla dislikes Zelda	sem	dislike ( isla , zelda )
Isla throws Bob	sem	throw ( isla , bob )
Isla throws Claire	sem	throw ( isla , claire )
Isla throws Daniel	sem	throw ( isla , daniel )
Isla throws Francis	sem	throw ( isla , francis )
Isla throws Henry	sem	throw ( isla , henry )
Isla throws Isla	sem	throw ( isla , isla )
Isla throws John	sem	throw ( isla , john )
Isla throws Katherine	sem	throw ( isla , katherine )
Isla throws Lewis	sem	throw ( isla , lewis )
Isla throws Margaret	sem	throw ( isla , margaret )
Isla throws Neha	sem	throw ( isla , neha )
Isla throws Oswald	sem	throw ( isla , oswald )
Isla throws Quinn	sem	throw ( isla , quinn )
Isla throws Rachael	sem	throw ( isla , rachael )
Isla throws Tracy	sem	throw ( isla , tracy )
Isla throws Ursula	sem	throw ( isla , ursula )
Isla throws Victor	sem	throw ( isla , victor )
Isla throws Winnifred	sem	throw ( isla , winnifred )
Isla throws Xerxes	sem	throw ( isla , xerxes )
Isla throws Yvette	sem	throw ( isla , yvettte )
Isla throws Zelda	sem	throw ( isla , zelda )
Isla notices Claire	sem	notice ( isla , claire )
Isla notices Daniel	sem	notice ( isla , daniel )
Isla notices Eliza	sem	notice ( isla , eliza )
Isla notices Francis	sem	notice ( isla , francis )
Isla notices John	sem	notice ( isla , john )
Isla notices Neha	sem	notice ( isla , neha )
Isla notices Oswald	sem	notice ( isla , oswald )
Isla notices Patricia	sem	notice ( isla , patricia )
Isla notices Quinn	sem	notice ( isla , quinn )
Isla notices Rachael	sem	notice ( isla , rachael )
Isla notices Samuel	sem	notice ( isla , samuel )
Isla notices Tracy	sem	notice ( isla , tracy )
Isla notices Ursula	sem	notice ( isla , ursula )
Isla notices Winnifred	sem	notice ( isla , winnifred )
Isla notices Yvette	sem	notice ( isla , yvettte )
Isla notices Zelda	sem	notice ( isla , zelda )
Isla knows Bob	sem	know ( isla , bob )
Isla knows Daniel	sem	know ( isla , daniel )
Isla knows Eliza	sem	know ( isla , eliza )
Isla knows Francis	sem	know ( isla , francis )
Isla knows Grace	sem	know ( isla , grace )
Isla knows Henry	sem	know ( isla , henry )
Isla knows Isla	sem	know ( isla , isla )
Isla knows John	sem	know ( isla , john )
Isla knows Katherine	sem	know ( isla , katherine )
Isla knows Lewis	sem	know ( isla , lewis )
Isla knows Margaret	sem	know ( isla , margaret )
Isla knows Oswald	sem	know ( isla , oswald )
Isla knows Patricia	sem	know ( isla , patricia )
Isla knows Rachael	sem	know ( isla , rachael )
Isla knows Samuel	sem	know ( isla , samuel )
Isla knows Tracy	sem	know ( isla , tracy )
Isla knows Victor	sem	know ( isla , victor )
Isla knows Winnifred	sem	know ( isla , winnifred )
Isla knows Zelda	sem	know ( isla , zelda )
Isla sees herself	sem	see ( isla , isla )
Isla meets herself	sem	meet ( isla , isla )
Isla likes herself	sem	like ( isla , isla )
Isla throws herself	sem	throw ( isla , isla )
Isla notices herself	sem	notice ( isla , isla )
Isla knows herself	sem	know ( isla , isla )
John sleeps	sem	sleep ( john )
John eats	sem	eat ( john )
John runs	sem	run ( john )
John sings	sem	sing ( john )
John dances	sem	dance ( john )
John flies	sem	fly ( john )
John slumbers	sem	slumber ( john )
John sees Bob	sem	see ( john , bob )
John sees Claire	sem	see ( john , claire )
John sees Daniel	sem	see ( john , daniel )
John sees Francis	sem	see ( john , francis )
John sees Grace	sem	see ( john , grace )
John sees Henry	sem	see ( john , henry )
John sees Isla	sem	see ( john , isla )
John sees John	sem	see ( john , john )
John sees Katherine	sem	see ( john , katherine )
John sees Margaret	sem	see ( john , margaret )
John sees Neha	sem	see ( john , neha )
John sees Oswald	sem	see ( john , oswald )
John sees Patricia	sem	see ( john , patricia )
John sees Quinn	sem	see ( john , quinn )
John sees Samuel	sem	see ( john , samuel )
John sees Tracy	sem	see ( john , tracy )
John sees Ursula	sem	see ( john , ursula )
John sees Victor	sem	see ( john , victor )
John sees Winnifred	sem	see ( john , winnifred )
John sees Yvette	sem	see ( john , yvettte )
John sees Zelda	sem	see ( john , zelda )
John meets Bob	sem	meet ( john , bob )
John meets Daniel	sem	meet ( john , daniel )
John meets Eliza	sem	meet ( john , eliza )
John meets Francis	sem	meet ( john , francis )
John meets Grace	sem	meet ( john , grace )
John meets Henry	sem	meet ( john , henry )
John meets Isla	sem	meet ( john , isla )
John meets John	sem	meet ( john , john )
John meets Katherine	sem	meet ( john , katherine )
John meets Lewis	sem	meet ( john , lewis )
John meets Margaret	sem	meet ( john , margaret )
John meets Neha	sem	meet ( john , neha )
John meets Patricia	sem	meet ( john , patricia )
John meets Quinn	sem	meet ( john , quinn )
John meets Samuel	sem	meet ( john , samuel )
John meets Tracy	sem	meet ( john , tracy )
John meets Ursula	sem	meet ( john , ursula )
John meets Victor	sem	meet ( john , victor )
John meets Xerxes	sem	meet ( john , xerxes )
John meets Yvette	sem	meet ( john , yvettte )
John meets Zelda	sem	meet ( john , zelda )
John likes Bob	sem	like ( john , bob )
John likes Claire	sem	like ( john , claire )
John likes Daniel	sem	like ( john , daniel )
John likes Eliza	sem	like ( john , eliza )
John likes Francis	sem	like ( john , francis )
John likes Grace	sem	like ( john , grace )
John likes Henry	sem	like ( john , henry )
John likes Isla	sem	like ( john , isla )
John likes John	sem	like ( john , john )
John likes Katherine	sem	like ( john , katherine )
John likes Margaret	sem	like ( john , margaret )
John likes Neha	sem	like ( john , neha )
John likes Oswald	sem	like ( john , oswald )
John likes Patricia	sem	like ( john , patricia )
John likes Quinn	sem	like ( john , quinn )
John likes Rachael	sem	like ( john , rachael )
John likes Tracy	sem	like ( john , tracy )
John likes Ursula	sem	like ( john , ursula )
John likes Victor	sem	like ( john , victor )
John likes Xerxes	sem	like ( john , xerxes )
John likes Yvette	sem	like ( john , yvettte )
John likes Zelda	sem	like ( john , zelda )
John dislikes Bob	sem	dislike ( john , bob )
John dislikes Claire	sem	dislike ( john , claire )
John dislikes Daniel	sem	dislike ( john , daniel )
John dislikes Eliza	sem	dislike ( john , eliza )
John dislikes Grace	sem	dislike ( john , grace )
John dislikes Henry	sem	dislike ( john , henry )
John dislikes Katherine	sem	dislike ( john , katherine )
John dislikes Margaret	sem	dislike ( john , margaret )
John dislikes Neha	sem	dislike ( john , neha )
John dislikes Oswald	sem	dislike ( john , oswald )
John dislikes Patricia	sem	dislike ( john , patricia )
John dislikes Quinn	sem	dislike ( john , quinn )
John dislikes Samuel	sem	dislike ( john , samuel )
John dislikes Tracy	sem	dislike ( john , tracy )
John dislikes Victor	sem	dislike ( john , victor )
John dislikes Winnifred	sem	dislike ( john , winnifred )
John dislikes Xerxes	sem	dislike ( john , xerxes )
John dislikes Yvette	sem	dislike ( john , yvettte )
John dislikes Zelda	sem	dislike ( john , zelda )
John throws Bob	sem	throw ( john , bob )
John throws Claire	sem	throw ( john , claire )
John throws Daniel	sem	throw ( john , daniel )
John throws Francis	sem	throw ( john , francis )
John throws Grace	sem	throw ( john , grace )
John throws Henry	sem	throw ( john , henry )
John throws Isla	sem	throw ( john , isla )
John throws John	sem	throw ( john , john )
John throws Katherine	sem	throw ( john , katherine )
John throws Lewis	sem	throw ( john , lewis )
John throws Margaret	sem	throw ( john , margaret )
John throws Oswald	sem	throw ( john , oswald )
John throws Patricia	sem	throw ( john , patricia )
John throws Samuel	sem	throw ( john , samuel )
John throws Tracy	sem	throw ( john , tracy )
John throws Winnifred	sem	throw ( john , winnifred )
John throws Xerxes	sem	throw ( john , xerxes )
John throws Yvette	sem	throw ( john , yvettte )
John throws Zelda	sem	throw ( john , zelda )
John notices Bob	sem	notice ( john , bob )
John notices Claire	sem	notice ( john , claire )
John notices Daniel	sem	notice ( john , daniel )
John notices Eliza	sem	notice ( john , eliza )
John notices Francis	sem	notice ( john , francis )
John notices Henry	sem	notice ( john , henry )
John notices Isla	sem	notice ( john , isla )
John notices John	sem	notice ( john , john )
John notices Katherine	sem	notice ( john , katherine )
John notices Lewis	sem	notice ( john , lewis )
John notices Margaret	sem	notice ( john , margaret )
John notices Neha	sem	notice ( john , neha )
John notices Oswald	sem	notice ( john , oswald )
John notices Quinn	sem	notice ( john , quinn )
John notices Rachael	sem	notice ( john , rachael )
John notices Samuel	sem	notice ( john , samuel )
John notices Ursula	sem	notice ( john , ursula )
John notices Victor	sem	notice ( john , victor )
John notices Winnifred	sem	notice ( john , winnifred )
John notices Xerxes	sem	notice ( john , xerxes )
John notices Zelda	sem	notice ( john , zelda )
John knows Bob	sem	know ( john , bob )
John knows Claire	sem	know ( john , claire )
John knows Eliza	sem	know ( john , eliza )
John knows Francis	sem	know ( john , francis )
John knows Grace	sem	know ( john , grace )
John knows Henry	sem	know ( john , henry )
John knows John	sem	know ( john , john )
John knows Katherine	sem	know ( john , katherine )
John knows Lewis	sem	know ( john , lewis )
John knows Margaret	sem	know ( john , margaret )
John knows Neha	sem	know ( john , neha )
John knows Oswald	sem	know ( john , oswald )
John knows Patricia	sem	know ( john , patricia )
John knows Quinn	sem	know ( john , quinn )
John knows Rachael	sem	know ( john , rachael )
John knows Samuel	sem	know ( john , samuel )
John knows Tracy	sem	know ( john , tracy )
John knows Ursula	sem	know ( john , ursula )
John knows Winnifred	sem	know ( john , winnifred )
John knows Zelda	sem	know ( john , zelda )
John sees himself	sem	see ( john , john )
John meets himself	sem	meet ( john , john )
John likes himself	sem	like ( john , john )
John dislikes himself	sem	dislike ( john , john )
John throws himself	sem	throw ( john , john )
John knows himself	sem	know ( john , john )
Katherine walks	sem	walk ( katherine )
Katherine sleeps	sem	sleep ( katherine )
Katherine eats	sem	eat ( katherine )
Katherine sings	sem	sing ( katherine )
Katherine flies	sem	fly ( katherine )
Katherine slumbers	sem	slumber ( katherine )
Katherine sees Bob	sem	see ( katherine , bob )
Katherine sees Claire	sem	see ( katherine , claire )
Katherine sees Daniel	sem	see ( katherine , daniel )
Katherine sees Eliza	sem	see ( katherine , eliza )
Katherine sees Francis	sem	see ( katherine , francis )
Katherine sees Grace	sem	see ( katherine , grace )
Katherine sees Henry	sem	see ( katherine , henry )
Katherine sees Isla	sem	see ( katherine , isla )
Katherine sees John	sem	see ( katherine , john )
Katherine sees Katherine	sem	see ( katherine , katherine )
Katherine sees Lewis	sem	see ( katherine , lewis )
Katherine sees Neha	sem	see ( katherine , neha )
Katherine sees Oswald	sem	see ( katherine , oswald )
Katherine sees Patricia	sem	see ( katherine , patricia )
Katherine sees Rachael	sem	see ( katherine , rachael )
Katherine sees Samuel	sem	see ( katherine , samuel )
Katherine sees Tracy	sem	see ( katherine , tracy )
Katherine sees Ursula	sem	see ( katherine , ursula )
Katherine sees Winnifred	sem	see ( katherine , winnifred )
Katherine sees Xerxes	sem	see ( katherine , xerxes )
Katherine sees Yvette	sem	see ( katherine , yvettte )
Katherine meets Bob	sem	meet ( katherine , bob )
Katherine meets Claire	sem	meet ( katherine , claire )
Katherine meets Daniel	sem	meet ( katherine , daniel )
Katherine meets Eliza	sem	meet ( katherine , eliza )
Katherine meets Grace	sem	meet ( katherine , grace )
Katherine meets Henry	sem	meet ( katherine , henry )
Katherine meets Isla	sem	meet ( katherine , isla )
Katherine meets John	sem	meet ( katherine , john )
Katherine meets Katherine	sem	meet ( katherine , katherine )
Katherine meets Neha	sem	meet ( katherine , neha )
Katherine meets Oswald	sem	meet ( katherine , oswald )
Katherine meets Quinn	sem	meet ( katherine , quinn )
Katherine meets Rachael	sem	meet ( katherine , rachael )
Katherine meets Tracy	sem	meet ( katherine , tracy )
Katherine meets Victor	sem	meet ( katherine , victor )
Katherine meets Xerxes	sem	meet ( katherine , xerxes )
Katherine meets Yvette	sem	meet ( katherine , yvettte )
Katherine meets Zelda	sem	meet ( katherine , zelda )
Katherine likes Bob	sem	like ( katherine , bob )
Katherine likes Claire	sem	like ( katherine , claire )
Katherine likes Eliza	sem	like ( katherine , eliza )
Katherine likes Henry	sem	like ( katherine , henry )
Katherine likes Isla	sem	like ( katherine , isla )
Katherine likes John	sem	like ( katherine , john )
Katherine likes Katherine	sem	like ( katherine , katherine )
Katherine likes Lewis	sem	like ( katherine , lewis )
Katherine likes Margaret	sem	like ( katherine , margaret )
Katherine likes Neha	sem	like ( katherine , neha )
Katherine likes Oswald	sem	like ( katherine , oswald )
Katherine likes Patricia	sem	like ( katherine , patricia )
Katherine likes Quinn	sem	like ( katherine , quinn )
Katherine likes Rachael	sem	like ( katherine , rachael )
Katherine likes Samuel	sem	like ( katherine , samuel )
Katherine likes Tracy	sem	like ( katherine , tracy )
Katherine likes Ursula	sem	like ( katherine , ursula )
Katherine likes Victor	sem	like ( katherine , victor )
Katherine likes Winnifred	sem	like ( katherine , winnifred )
Katherine likes Xerxes	sem	like ( katherine , xerxes )
Katherine likes Yvette	sem	like ( katherine , yvettte )
Katherine likes Zelda	sem	like ( katherine , zelda )
Katherine dislikes Claire	sem	dislike ( katherine , claire )
Katherine dislikes Daniel	sem	dislike ( katherine , daniel )
Katherine dislikes Eliza	sem	dislike ( katherine , eliza )
Katherine dislikes Francis	sem	dislike ( katherine , francis )
Katherine dislikes Grace	sem	dislike ( katherine , grace )
Katherine dislikes John	sem	dislike ( katherine , john )
Katherine dislikes Katherine	sem	dislike ( katherine , katherine )
Katherine dislikes Lewis	sem	dislike ( katherine , lewis )
Katherine dislikes Margaret	sem	dislike ( katherine , margaret )
Katherine dislikes Neha	sem	dislike ( katherine , neha )
Katherine dislikes Oswald	sem	dislike ( katherine , oswald )
Katherine dislikes Patricia	sem	dislike ( katherine , patricia )
Katherine dislikes Quinn	sem	dislike ( katherine , quinn )
Katherine dislikes Rachael	sem	dislike ( katherine , rachael )
Katherine dislikes Samuel	sem	dislike ( katherine , samuel )
Katherine dislikes Tracy	sem	dislike ( katherine , tracy )
Katherine dislikes Ursula	sem	dislike ( katherine , ursula )
Katherine dislikes Winnifred	sem	dislike ( katherine , winnifred )
Katherine dislikes Xerxes	sem	dislike ( katherine , xerxes )
Katherine dislikes Yvette	sem	dislike ( katherine , yvettte )
Katherine throws Bob	sem	throw ( katherine , bob )
Katherine throws Daniel	sem	throw ( katherine , daniel )
Katherine throws Francis	sem	throw ( katherine , francis )
Katherine throws Grace	sem	throw ( katherine , grace )
Katherine throws Henry	sem	throw ( katherine , henry )
Katherine throws John	sem	throw ( katherine , john )
Katherine throws Katherine	sem	throw ( katherine , katherine )
Katherine throws Lewis	sem	throw ( katherine , lewis )
Katherine throws Margaret	sem	throw ( katherine , margaret )
Katherine throws Oswald	sem	throw ( katherine , oswald )
Katherine throws Patricia	sem	throw ( katherine , patricia )
Katherine throws Quinn	sem	throw ( katherine , quinn )
Katherine throws Rachael	sem	throw ( katherine , rachael )
Katherine throws Samuel	sem	throw ( katherine , samuel )
Katherine throws Tracy	sem	throw ( katherine , tracy )
Katherine throws Ursula	sem	throw ( katherine , ursula )
Katherine throws Victor	sem	throw ( katherine , victor )
Katherine throws Winnifred	sem	throw ( katherine , winnifred )
Katherine throws Xerxes	sem	throw ( katherine , xerxes )
Katherine throws Yvette	sem	throw ( katherine , yvettte )
Katherine throws Zelda	sem	throw ( katherine , zelda )
Katherine notices Bob	sem	notice ( katherine , bob )
Katherine notices Claire	sem	notice ( katherine , claire )
Katherine notices Daniel	sem	notice ( katherine , daniel )
Katherine notices John	sem	notice ( katherine , john )
Katherine notices Katherine	sem	notice ( katherine , katherine )
Katherine notices Lewis	sem	notice ( katherine , lewis )
Katherine notices Neha	sem	notice ( katherine , neha )
Katherine notices Patricia	sem	notice ( katherine , patricia )
Katherine notices Rachael	sem	notice ( katherine , rachael )
Katherine notices Tracy	sem	notice ( katherine , tracy )
Katherine notices Ursula	sem	notice ( katherine , ursula )
Katherine notices Victor	sem	notice ( katherine , victor )
Katherine notices Winnifred	sem	notice ( katherine , winnifred )
Katherine notices Xerxes	sem	notice ( katherine , xerxes )
Katherine notices Yvette	sem	notice ( katherine , yvettte )
Katherine notices Zelda	sem	notice ( katherine , zelda )
Katherine knows Bob	sem	know ( katherine , bob )
Katherine knows Claire	sem	know ( katherine , claire )
Katherine knows Eliza	sem	know ( katherine , eliza )
Katherine knows Francis	sem	know ( katherine , francis )
Katherine knows Grace	sem	know ( katherine , grace )
Katherine knows Henry	sem	know ( katherine , henry )
Katherine knows Isla	sem	know ( katherine , isla )
Katherine knows John	sem	know ( katherine , john )
Katherine knows Katherine	sem	know ( katherine , katherine )
Katherine knows Margaret	sem	know ( katherine , margaret )
Katherine knows Oswald	sem	know ( katherine , oswald )
Katherine knows Patricia	sem	know ( katherine , patricia )
Katherine knows Quinn	sem	know ( katherine , quinn )
Katherine knows Rachael	sem	know ( katherine , rachael )
Katherine knows Samuel	sem	know ( katherine , samuel )
Katherine knows Tracy	sem	know ( katherine , tracy )
Katherine knows Ursula	sem	know ( katherine , ursula )
Katherine knows Victor	sem	know ( katherine , victor )
Katherine knows Winnifred	sem	know ( katherine , winnifred )
Katherine knows Xerxes	sem	know ( katherine , xerxes )
Katherine knows Yvette	sem	know ( katherine , yvettte )
Katherine knows Zelda	sem	know ( katherine , zelda )
Katherine sees herself	sem	see ( katherine , katherine )
Katherine meets herself	sem	meet ( katherine , katherine )
Katherine likes herself	sem	like ( katherine , katherine )
Katherine throws herself	sem	throw ( katherine , katherine )
Katherine notices herself	sem	notice ( katherine , katherine )
Katherine knows herself	sem	know ( katherine , katherine )
Lewis sleeps	sem	sleep ( lewis )
Lewis eats	sem	eat ( lewis )
Lewis sings	sem	sing ( lewis )
Lewis dances	sem	dance ( lewis )
Lewis flies	sem	fly ( lewis )
Lewis slumbers	sem	slumber ( lewis )
Lewis sees Bob	sem	see ( lewis , bob )
Lewis sees Daniel	sem	see ( lewis , daniel )
Lewis sees Eliza	sem	see ( lewis , eliza )
Lewis sees Francis	sem	see ( lewis , francis )
Lewis sees Henry	sem	see ( lewis , henry )
Lewis sees Isla	sem	see ( lewis , isla )
Lewis sees John	sem	see ( lewis , john )
Lewis sees Katherine	sem	see ( lewis , katherine )
Lewis sees Lewis	sem	see ( lewis , lewis )
Lewis sees Margaret	sem	see ( lewis , margaret )
Lewis sees Neha	sem	see ( lewis , neha )
Lewis sees Oswald	sem	see ( lewis , oswald )
Lewis sees Quinn	sem	see ( lewis , quinn )
Lewis sees Rachael	sem	see ( lewis , rachael )
Lewis sees Samuel	sem	see ( lewis , samuel )
Lewis sees Tracy	sem	see ( lewis , tracy )
Lewis sees Ursula	sem	see ( lewis , ursula )
Lewis sees Xerxes	sem	see ( lewis , xerxes )
Lewis sees Yvette	sem	see ( lewis , yvettte )
Lewis sees Zelda	sem	see ( lewis , zelda )
Lewis meets Bob	sem	meet ( lewis , bob )
Lewis meets Claire	sem	meet ( lewis , claire )
Lewis meets Daniel	sem	meet ( lewis , daniel )
Lewis meets Eliza	sem	meet ( lewis , eliza )
Lewis meets Henry	sem	meet ( lewis , henry )
Lewis meets Isla	sem	meet ( lewis , isla )
Lewis meets John	sem	meet ( lewis , john )
Lewis meets Katherine	sem	meet ( lewis , katherine )
Lewis meets Lewis	sem	meet ( lewis , lewis )
Lewis meets Margaret	sem	meet ( lewis , margaret )
Lewis meets Neha	sem	meet ( lewis , neha )
Lewis meets Rachael	sem	meet ( lewis , rachael )
Lewis meets Samuel	sem	meet ( lewis , samuel )
Lewis meets Ursula	sem	meet ( lewis , ursula )
Lewis meets Winnifred	sem	meet ( lewis , winnifred )
Lewis meets Yvette	sem	meet ( lewis , yvettte )
Lewis meets Zelda	sem	meet ( lewis , zelda )
Lewis likes Bob	sem	like ( lewis , bob )
Lewis likes Claire	sem	like ( lewis , claire )
Lewis likes Daniel	sem	like ( lewis , daniel )
Lewis likes Eliza	sem	like ( lewis , eliza )
Lewis likes Francis	sem	like ( lewis , francis )
Lewis likes Henry	sem	like ( lewis , henry )
Lewis likes Isla	sem	like ( lewis , isla )
Lewis likes John	sem	like ( lewis , john )
Lewis likes Katherine	sem	like ( lewis , katherine )
Lewis likes Oswald	sem	like ( lewis , oswald )
Lewis likes Patricia	sem	like ( lewis , patricia )
Lewis likes Quinn	sem	like ( lewis , quinn )
Lewis likes Rachael	sem	like ( lewis , rachael )
Lewis likes Samuel	sem	like ( lewis , samuel )
Lewis likes Ursula	sem	like ( lewis , ursula )
Lewis likes Victor	sem	like ( lewis , victor )
Lewis likes Winnifred	sem	like ( lewis , winnifred )
Lewis likes Xerxes	sem	like ( lewis , xerxes )
Lewis likes Yvette	sem	like ( lewis , yvettte )
Lewis dislikes Bob	sem	dislike ( lewis , bob )
Lewis dislikes Claire	sem	dislike ( lewis , claire )
Lewis dislikes Daniel	sem	dislike ( lewis , daniel )
Lewis dislikes Eliza	sem	dislike ( lewis , eliza )
Lewis dislikes Francis	sem	dislike ( lewis , francis )
Lewis dislikes Grace	sem	dislike ( lewis , grace )
Lewis dislikes Isla	sem	dislike ( lewis , isla )
Lewis dislikes John	sem	dislike ( lewis , john )
Lewis dislikes Katherine	sem	dislike ( lewis , katherine )
Lewis dislikes Margaret	sem	dislike ( lewis , margaret )
Lewis dislikes Neha	sem	dislike ( lewis , neha )
Lewis dislikes Oswald	sem	dislike ( lewis , oswald )
Lewis dislikes Patricia	sem	dislike ( lewis , patricia )
Lewis dislikes Quinn	sem	dislike ( lewis , quinn )
Lewis dislikes Rachael	sem	dislike ( lewis , rachael )
Lewis dislikes Samuel	sem	dislike ( lewis , samuel )
Lewis dislikes Tracy	sem	dislike ( lewis , tracy )
Lewis dislikes Ursula	sem	dislike ( lewis , ursula )
Lewis dislikes Victor	sem	dislike ( lewis , victor )
Lewis dislikes Winnifred	sem	dislike ( lewis , winnifred )
Lewis dislikes Yvette	sem	dislike ( lewis , yvettte )
Lewis dislikes Zelda	sem	dislike ( lewis , zelda )
Lewis throws Bob	sem	throw ( lewis , bob )
Lewis throws Claire	sem	throw ( lewis , claire )
Lewis throws Eliza	sem	throw ( lewis , eliza )
Lewis throws Francis	sem	throw ( lewis , francis )
Lewis throws Grace	sem	throw ( lewis , grace )
Lewis throws Henry	sem	throw ( lewis , henry )
Lewis throws Isla	sem	throw ( lewis , isla )
Lewis throws Katherine	sem	throw ( lewis , katherine )
Lewis throws Lewis	sem	throw ( lewis , lewis )
Lewis throws Margaret	sem	throw ( lewis , margaret )
Lewis throws Oswald	sem	throw ( lewis , oswald )
Lewis throws Patricia	sem	throw ( lewis , patricia )
Lewis throws Quinn	sem	throw ( lewis , quinn )
Lewis throws Samuel	sem	throw ( lewis , samuel )
Lewis throws Ursula	sem	throw ( lewis , ursula )
Lewis throws Victor	sem	throw ( lewis , victor )
Lewis throws Winnifred	sem	throw ( lewis , winnifred )
Lewis throws Xerxes	sem	throw ( lewis , xerxes )
Lewis throws Yvette	sem	throw ( lewis , yvettte )
Lewis notices Bob	sem	notice ( lewis , bob )
Lewis notices Claire	sem	notice ( lewis , claire )
Lewis notices Daniel	sem	notice ( lewis , daniel )
Lewis notices Eliza	sem	notice ( lewis , eliza )
Lewis notices Henry	sem	notice ( lewis , henry )
Lewis notices Isla	sem	notice ( lewis , isla )
Lewis notices Katherine	sem	notice ( lewis , katherine )
Lewis notices Lewis	sem	notice ( lewis , lewis )
Lewis notices Margaret	sem	notice ( lewis , margaret )
Lewis notices Neha	sem	notice ( lewis , neha )
Lewis notices Patricia	sem	notice ( lewis , patricia )
Lewis notices Rachael	sem	notice ( lewis , rachael )
Lewis notices Samuel	sem	notice ( lewis , samuel )
Lewis notices Tracy	sem	notice ( lewis , tracy )
Lewis notices Ursula	sem	notice ( lewis , ursula )
Lewis notices Victor	sem	notice ( lewis , victor )
Lewis notices Winnifred	sem	notice ( lewis , winnifred )
Lewis notices Yvette	sem	notice ( lewis , yvettte )
Lewis notices Zelda	sem	notice ( lewis , zelda )
Lewis knows Bob	sem	know ( lewis , bob )
Lewis knows Claire	sem	know ( lewis , claire )
Lewis knows Daniel	sem	know ( lewis , daniel )
Lewis knows Eliza	sem	know ( lewis , eliza )
Lewis knows Francis	sem	know ( lewis , francis )
Lewis knows Grace	sem	know ( lewis , grace )
Lewis knows Henry	sem	know ( lewis , henry )
Lewis knows Isla	sem	know ( lewis , isla )
Lewis knows John	sem	know ( lewis , john )
Lewis knows Katherine	sem	know ( lewis , katherine )
Lewis knows Margaret	sem	know ( lewis , margaret )
Lewis knows Oswald	sem	know ( lewis , oswald )
Lewis knows Patricia	sem	know ( lewis , patricia )
Lewis knows Quinn	sem	know ( lewis , quinn )
Lewis knows Rachael	sem	know ( lewis , rachael )
Lewis knows Samuel	sem	know ( lewis , samuel )
Lewis knows Tracy	sem	know ( lewis , tracy )
Lewis knows Victor	sem	know ( lewis , victor )
Lewis knows Xerxes	sem	know ( lewis , xerxes )
Lewis knows Zelda	sem	know ( lewis , zelda )
Lewis sees himself	sem	see ( lewis , lewis )
Lewis meets himself	sem	meet ( lewis , lewis )
Lewis likes himself	sem	like ( lewis , lewis )
Lewis throws himself	sem	throw ( lewis , lewis )
Lewis notices himself	sem	notice ( lewis , lewis )
Lewis knows himself	sem	know ( lewis , lewis )
Margaret walks	sem	walk ( margaret )
Margaret sleeps	sem	sleep ( margaret )
Margaret eats	sem	eat ( margaret )
Margaret runs	sem	run ( margaret )
Margaret sings	sem	sing ( margaret )
Margaret dances	sem	dance ( margaret )
Margaret flies	sem	fly ( margaret )
Margaret slumbers	sem	slumber ( margaret )
Margaret sees Bob	sem	see ( margaret , bob )
Margaret sees Claire	sem	see ( margaret , claire )
Margaret sees Daniel	sem	see ( margaret , daniel )
Margaret sees Francis	sem	see ( margaret , francis )
Margaret sees Grace	sem	see ( margaret , grace )
Margaret sees Henry	sem	see ( margaret , henry )
Margaret sees Isla	sem	see ( margaret , isla )
Margaret sees John	sem	see ( margaret , john )
Margaret sees Margaret	sem	see ( margaret , margaret )
Margaret sees Neha	sem	see ( margaret , neha )
Margaret sees Oswald	sem	see ( margaret , oswald )
Margaret sees Patricia	sem	see ( margaret , patricia )
Margaret sees Rachael	sem	see ( margaret , rachael )
Margaret sees Samuel	sem	see ( margaret , samuel )
Margaret sees Tracy	sem	see ( margaret , tracy )
Margaret sees Ursula	sem	see ( margaret , ursula )
Margaret sees Victor	sem	see ( margaret , victor )
Margaret sees Winnifred	sem	see ( margaret , winnifred )
Margaret sees Xerxes	sem	see ( margaret , xerxes )
Margaret meets Bob	sem	meet ( margaret , bob )
Margaret meets Daniel	sem	meet ( margaret , daniel )
Margaret meets Eliza	sem	meet ( margaret , eliza )
Margaret meets Francis	sem	meet ( margaret , francis )
Margaret meets Henry	sem	meet ( margaret , henry )
Margaret meets Lewis	sem	meet ( margaret , lewis )
Margaret meets Margaret	sem	meet ( margaret , margaret )
Margaret meets Neha	sem	meet ( margaret , neha )
Margaret meets Oswald	sem	meet ( margaret , oswald )
Margaret meets Quinn	sem	meet ( margaret , quinn )
Margaret meets Samuel	sem	meet ( margaret , samuel )
Margaret meets Tracy	sem	meet ( margaret , tracy )
Margaret meets Ursula	sem	meet ( margaret , ursula )
Margaret meets Victor	sem	meet ( margaret , victor )
Margaret meets Winnifred	sem	meet ( margaret , winnifred )
Margaret meets Xerxes	sem	meet ( margaret , xerxes )
Margaret meets Yvette	sem	meet ( margaret , yvettte )
Margaret meets Zelda	sem	meet ( margaret , zelda )
Margaret likes Bob	sem	like ( margaret , bob )
Margaret likes Claire	sem	like ( margaret , claire )
Margaret likes Daniel	sem	like ( margaret , daniel )
Margaret likes Eliza	sem	like ( margaret , eliza )
Margaret likes Grace	sem	like ( margaret , grace )
Margaret likes Henry	sem	like ( margaret , henry )
Margaret likes Isla	sem	like ( margaret , isla )
Margaret likes John	sem	like ( margaret , john )
Margaret likes Katherine	sem	like ( margaret , katherine )
Margaret likes Patricia	sem	like ( margaret , patricia )
Margaret likes Quinn	sem	like ( margaret , quinn )
Margaret likes Rachael	sem	like ( margaret , rachael )
Margaret likes Samuel	sem	like ( margaret , samuel )
Margaret likes Tracy	sem	like ( margaret , tracy )
Margaret likes Xerxes	sem	like ( margaret , xerxes )
Margaret likes Yvette	sem	like ( margaret , yvettte )
Margaret dislikes Bob	sem	dislike ( margaret , bob )
Margaret dislikes Claire	sem	dislike ( margaret , claire )
Margaret dislikes Daniel	sem	dislike ( margaret , daniel )
Margaret dislikes Eliza	sem	dislike ( margaret , eliza )
Margaret dislikes Francis	sem	dislike ( margaret , francis )
Margaret dislikes Grace	sem	dislike ( margaret , grace )
Margaret dislikes Henry	sem	dislike ( margaret , henry )
Margaret dislikes Isla	sem	dislike ( margaret , isla )
Margaret dislikes John	sem	dislike ( margaret , john )
Margaret dislikes Katherine	sem	dislike ( margaret , katherine )
Margaret dislikes Lewis	sem	dislike ( margaret , lewis )
Margaret dislikes Margaret	sem	dislike ( margaret , margaret )
Margaret dislikes Neha	sem	dislike ( margaret , neha )
Margaret dislikes Oswald	sem	dislike ( margaret , oswald )
Margaret dislikes Patricia	sem	dislike ( margaret , patricia )
Margaret dislikes Samuel	sem	dislike ( margaret , samuel )
Margaret dislikes Tracy	sem	dislike ( margaret , tracy )
Margaret dislikes Ursula	sem	dislike ( margaret , ursula )
Margaret dislikes Victor	sem	dislike ( margaret , victor )
Margaret dislikes Winnifred	sem	dislike ( margaret , winnifred )
Margaret dislikes Xerxes	sem	dislike ( margaret , xerxes )
Margaret dislikes Yvette	sem	dislike ( margaret , yvettte )
Margaret dislikes Zelda	sem	dislike ( margaret , zelda )
Margaret throws Bob	sem	throw ( margaret , bob )
Margaret throws Claire	sem	throw ( margaret , claire )
Margaret throws Daniel	sem	throw ( margaret , daniel )
Margaret throws Eliza	sem	throw ( margaret , eliza )
Margaret throws Francis	sem	throw ( margaret , francis )
Margaret throws Henry	sem	throw ( margaret , henry )
Margaret throws Isla	sem	throw ( margaret , isla )
Margaret throws Katherine	sem	throw ( margaret , katherine )
Margaret throws Oswald	sem	throw ( margaret , oswald )
Margaret throws Patricia	sem	throw ( margaret , patricia )
Margaret throws Quinn	sem	throw ( margaret , quinn )
Margaret throws Samuel	sem	throw ( margaret , samuel )
Margaret throws Winnifred	sem	throw ( margaret , winnifred )
Margaret throws Xerxes	sem	throw ( margaret , xerxes )
Margaret throws Yvette	sem	throw ( margaret , yvettte )
Margaret notices Daniel	sem	notice ( margaret , daniel )
Margaret notices Eliza	sem	notice ( margaret , eliza )
Margaret notices Francis	sem	notice ( margaret , francis )
Margaret notices Grace	sem	notice ( margaret , grace )
Margaret notices John	sem	notice ( margaret , john )
Margaret notices Katherine	sem	notice ( margaret , katherine )
Margaret notices Lewis	sem	notice ( margaret , lewis )
Margaret notices Margaret	sem	notice ( margaret , margaret )
Margaret notices Oswald	sem	notice ( margaret , oswald )
Margaret notices Patricia	sem	notice ( margaret , patricia )
Margaret notices Quinn	sem	notice ( margaret , quinn )
Margaret notices Samuel	sem	notice ( margaret , samuel )
Margaret notices Tracy	sem	notice ( margaret , tracy )
Margaret notices Ursula	sem	notice ( margaret , ursula )
Margaret notices Victor	sem	notice ( margaret , victor )
Margaret notices Winnifred	sem	notice ( margaret , winnifred )
Margaret notices Yvette	sem	notice ( margaret , yvettte )
Margaret notices Zelda	sem	notice ( margaret , zelda )
Margaret knows Bob	sem	know ( margaret , bob )
Margaret knows Claire	sem	know ( margaret , claire )
Margaret knows Daniel	sem	know ( margaret , daniel )
Margaret knows Eliza	sem	know ( margaret , eliza )
Margaret knows Francis	sem	know ( margaret , francis )
Margaret knows Henry	sem	know ( margaret , henry )
Margaret knows Isla	sem	know ( margaret , isla )
Margaret knows John	sem	know ( margaret , john )
Margaret knows Neha	sem	know ( margaret , neha )
Margaret knows Oswald	sem	know ( margaret , oswald )
Margaret knows Patricia	sem	know ( margaret , patricia )
Margaret knows Quinn	sem	know ( margaret , quinn )
Margaret knows Rachael	sem	know ( margaret , rachael )
Margaret knows Samuel	sem	know ( margaret , samuel )
Margaret knows Ursula	sem	know ( margaret , ursula )
Margaret knows Victor	sem	know ( margaret , victor )
Margaret knows Winnifred	sem	know ( margaret , winnifred )
Margaret knows Xerxes	sem	know ( margaret , xerxes )
Margaret knows Yvette	sem	know ( margaret , yvettte )
Margaret knows Zelda	sem	know ( margaret , zelda )
Margaret sees herself	sem	see ( margaret , margaret )
Margaret meets herself	sem	meet ( margaret , margaret )
Margaret throws herself	sem	throw ( margaret , margaret )
Neha walks	sem	walk ( neha )
Neha eats	sem	eat ( neha )
Neha sings	sem	sing ( neha )
Neha flies	sem	fly ( neha )
Neha slumbers	sem	slumber ( neha )
Neha sees Bob	sem	see ( neha , bob )
Neha sees Claire	sem	see ( neha , claire )
Neha sees Daniel	sem	see ( neha , daniel )
Neha sees Eliza	sem	see ( neha , eliza )
Neha sees Francis	sem	see ( neha , francis )
Neha sees Grace	sem	see ( neha , grace )
Neha sees Henry	sem	see ( neha , henry )
Neha sees Margaret	sem	see ( neha , margaret )
Neha sees Neha	sem	see ( neha , neha )
Neha sees Oswald	sem	see ( neha , oswald )
Neha sees Patricia	sem	see ( neha , patricia )
Neha sees Quinn	sem	see ( neha , quinn )
Neha sees Rachael	sem	see ( neha , rachael )
Neha sees Samuel	sem	see ( neha , samuel )
Neha sees Victor	sem	see ( neha , victor )
Neha sees Winnifred	sem	see ( neha , winnifred )
Neha sees Xerxes	sem	see ( neha , xerxes )
Neha sees Yvette	sem	see ( neha , yvettte )
Neha sees Zelda	sem	see ( neha , zelda )
Neha meets Claire	sem	meet ( neha , claire )
Neha meets Daniel	sem	meet ( neha , daniel )
Neha meets Eliza	sem	meet ( neha , eliza )
Neha meets Grace	sem	meet ( neha , grace )
Neha meets Henry	sem	meet ( neha , henry )
Neha meets Isla	sem	meet ( neha , isla )
Neha meets John	sem	meet ( neha , john )
Neha meets Katherine	sem	meet ( neha , katherine )
Neha meets Lewis	sem	meet ( neha , lewis )
Neha meets Margaret	sem	meet ( neha , margaret )
Neha meets Neha	sem	meet ( neha , neha )
Neha meets Patricia	sem	meet ( neha , patricia )
Neha meets Rachael	sem	meet ( neha , rachael )
Neha meets Tracy	sem	meet ( neha , tracy )
Neha meets Ursula	sem	meet ( neha , ursula )
Neha meets Victor	sem	meet ( neha , victor )
Neha meets Winnifred	sem	meet ( neha , winnifred )
Neha meets Yvette	sem	meet ( neha , yvettte )
Neha meets Zelda	sem	meet ( neha , zelda )
Neha likes Claire	sem	like ( neha , claire )
Neha likes Daniel	sem	like ( neha , daniel )
Neha likes Eliza	sem	like ( neha , eliza )
Neha likes Francis	sem	like ( neha , francis )
Neha likes Grace	sem	like ( neha , grace )
Neha likes Henry	sem	like ( neha , henry )
Neha likes John	sem	like ( neha , john )
Neha likes Lewis	sem	like ( neha , lewis )
Neha likes Margaret	sem	like ( neha , margaret )
Neha likes Oswald	sem	like ( neha , oswald )
Neha likes Patricia	sem	like ( neha , patricia )
Neha likes Quinn	sem	like ( neha , quinn )
Neha likes Samuel	sem	like ( neha , samuel )
Neha likes Tracy	sem	like ( neha , tracy )
Neha likes Victor	sem	like ( neha , victor )
Neha likes Winnifred	sem	like ( neha , winnifred )
Neha likes Yvette	sem	like ( neha , yvettte )
Neha dislikes Bob	sem	dislike ( neha , bob )
Neha dislikes Claire	sem	dislike ( neha , claire )
Neha dislikes Daniel	sem	dislike ( neha , daniel )
Neha dislikes Francis	sem	dislike ( neha , francis )
Neha dislikes Grace	sem	dislike ( neha , grace )
Neha dislikes Isla	sem	dislike ( neha , isla )
Neha dislikes Margaret	sem	dislike ( neha , margaret )
Neha dislikes Neha	sem	dislike ( neha , neha )
Neha dislikes Oswald	sem	dislike ( neha , oswald )
Neha dislikes Patricia	sem	dislike ( neha , patricia )
Neha dislikes Samuel	sem	dislike ( neha , samuel )
Neha dislikes Tracy	sem	dislike ( neha , tracy )
Neha dislikes Ursula	sem	dislike ( neha , ursula )
Neha dislikes Victor	sem	dislike ( neha , victor )
Neha dislikes Xerxes	sem	dislike ( neha , xerxes )
Neha dislikes Yvette	sem	dislike ( neha , yvettte )
Neha dislikes Zelda	sem	dislike ( neha , zelda )
Neha throws Bob	sem	throw ( neha , bob )
Neha throws Claire	sem	throw ( neha , claire )
Neha throws Daniel	sem	throw ( neha , daniel )
Neha throws Eliza	sem	throw ( neha , eliza )
Neha throws Francis	sem	throw ( neha , francis )
Neha throws Grace	sem	throw ( neha , grace )
Neha throws Isla	sem	throw ( neha , isla )
Neha throws Margaret	sem	throw ( neha , margaret )
Neha throws Neha	sem	throw ( neha , neha )
Neha throws Patricia	sem	throw ( neha , patricia )
Neha throws Quinn	sem	throw ( neha , quinn )
Neha throws Rachael	sem	throw ( neha , rachael )
Neha throws Samuel	sem	throw ( neha , samuel )
Neha throws Tracy	sem	throw ( neha , tracy )
Neha throws Ursula	sem	throw ( neha , ursula )
Neha throws Victor	sem	throw ( neha , victor )
Neha throws Winnifred	sem	throw ( neha , winnifred )
Neha throws Xerxes	sem	throw ( neha , xerxes )
Neha throws Yvette	sem	throw ( neha , yvettte )
Neha throws Zelda	sem	throw ( neha , zelda )
Neha notices Claire	sem	notice ( neha , claire )
Neha notices Daniel	sem	notice ( neha , daniel )
Neha notices Eliza	sem	notice ( neha , eliza )
Neha notices Francis	sem	notice ( neha , francis )
Neha notices Grace	sem	notice ( neha , grace )
Neha notices Isla	sem	notice ( neha , isla )
Neha notices John	sem	notice ( neha , john )
Neha notices Katherine	sem	notice ( neha , katherine )
Neha notices Lewis	sem	notice ( neha , lewis )
Neha notices Margaret	sem	notice ( neha , margaret )
Neha notices Neha	sem	notice ( neha , neha )
Neha notices Oswald	sem	notice ( neha , oswald )
Neha notices Quinn	sem	notice ( neha , quinn )
Neha notices Rachael	sem	notice ( neha , rachael )
Neha notices Samuel	sem	notice ( neha , samuel )
Neha notices Tracy	sem	notice ( neha , tracy )
Neha notices Victor	sem	notice ( neha , victor )
Neha notices Winnifred	sem	notice ( neha , winnifred )
Neha notices Xerxes	sem	notice ( neha , xerxes )
Neha notices Yvette	sem	notice ( neha , yvettte )
Neha notices Zelda	sem	notice ( neha , zelda )
Neha knows Bob	sem	know ( neha , bob )
Neha knows Eliza	sem	know ( neha , eliza )
Neha knows Francis	sem	know ( neha , francis )
Neha knows Grace	sem	know ( neha , grace )
Neha knows Henry	sem	know ( neha , henry )
Neha knows John	sem	know ( neha , john )
Neha knows Katherine	sem	know ( neha , katherine )
Neha knows Lewis	sem	know ( neha , lewis )
Neha knows Margaret	sem	know ( neha , margaret )
Neha knows Neha	sem	know ( neha , neha )
Neha knows Oswald	sem	know ( neha , oswald )
Neha knows Patricia	sem	know ( neha , patricia )
Neha knows Samuel	sem	know ( neha , samuel )
Neha knows Tracy	sem	know ( neha , tracy )
Neha knows Ursula	sem	know ( neha , ursula )
Neha knows Victor	sem	know ( neha , victor )
Neha knows Winnifred	sem	know ( neha , winnifred )
Neha knows Xerxes	sem	know ( neha , xerxes )
Neha knows Yvette	sem	know ( neha , yvettte )
Neha sees herself	sem	see ( neha , neha )
Neha likes herself	sem	like ( neha , neha )
Neha dislikes herself	sem	dislike ( neha , neha )
Neha throws herself	sem	throw ( neha , neha )
Neha notices herself	sem	notice ( neha , neha )
Neha knows herself	sem	know ( neha , neha )
Oswald sleeps	sem	sleep ( oswald )
Oswald eats	sem	eat ( oswald )
Oswald runs	sem	run ( oswald )
Oswald sings	sem	sing ( oswald )
Oswald flies	sem	fly ( oswald )
Oswald slumbers	sem	slumber ( oswald )
Oswald sees Bob	sem	see ( oswald , bob )
Oswald sees Eliza	sem	see ( oswald , eliza )
Oswald sees Grace	sem	see ( oswald , grace )
Oswald sees Isla	sem	see ( oswald , isla )
Oswald sees John	sem	see ( oswald , john )
Oswald sees Katherine	sem	see ( oswald , katherine )
Oswald sees Lewis	sem	see ( oswald , lewis )
Oswald sees Neha	sem	see ( oswald , neha )
Oswald sees Oswald	sem	see ( oswald , oswald )
Oswald sees Patricia	sem	see ( oswald , patricia )
Oswald sees Quinn	sem	see ( oswald , quinn )
Oswald sees Rachael	sem	see ( oswald , rachael )
Oswald sees Samuel	sem	see ( oswald , samuel )
Oswald sees Tracy	sem	see ( oswald , tracy )
Oswald sees Ursula	sem	see ( oswald , ursula )
Oswald sees Victor	sem	see ( oswald , victor )
Oswald sees Winnifred	sem	see ( oswald , winnifred )
Oswald sees Xerxes	sem	see ( oswald , xerxes )
Oswald meets Bob	sem	meet ( oswald , bob )
Oswald meets Claire	sem	meet ( oswald , claire )
Oswald meets Daniel	sem	meet ( oswald , daniel )
Oswald meets Eliza	sem	meet ( oswald , eliza )
Oswald meets Francis	sem	meet ( oswald , francis )
Oswald meets Grace	sem	meet ( oswald , grace )
Oswald meets Henry	sem	meet ( oswald , henry )
Oswald meets John	sem	meet ( oswald , john )
Oswald meets Katherine	sem	meet ( oswald , katherine )
Oswald meets Lewis	sem	meet ( oswald , lewis )
Oswald meets Margaret	sem	meet ( oswald , margaret )
Oswald meets Neha	sem	meet ( oswald , neha )
Oswald meets Oswald	sem	meet ( oswald , oswald )
Oswald meets Quinn	sem	meet ( oswald , quinn )
Oswald meets Rachael	sem	meet ( oswald , rachael )
Oswald meets Samuel	sem	meet ( oswald , samuel )
Oswald meets Tracy	sem	meet ( oswald , tracy )
Oswald meets Ursula	sem	meet ( oswald , ursula )
Oswald meets Victor	sem	meet ( oswald , victor )
Oswald meets Winnifred	sem	meet ( oswald , winnifred )
Oswald meets Yvette	sem	meet ( oswald , yvettte )
Oswald meets Zelda	sem	meet ( oswald , zelda )
Oswald likes Bob	sem	like ( oswald , bob )
Oswald likes Claire	sem	like ( oswald , claire )
Oswald likes Eliza	sem	like ( oswald , eliza )
Oswald likes John	sem	like ( oswald , john )
Oswald likes Katherine	sem	like ( oswald , katherine )
Oswald likes Lewis	sem	like ( oswald , lewis )
Oswald likes Margaret	sem	like ( oswald , margaret )
Oswald likes Neha	sem	like ( oswald , neha )
Oswald likes Patricia	sem	like ( oswald , patricia )
Oswald likes Quinn	sem	like ( oswald , quinn )
Oswald likes Rachael	sem	like ( oswald , rachael )
Oswald likes Samuel	sem	like ( oswald , samuel )
Oswald likes Tracy	sem	like ( oswald , tracy )
Oswald likes Ursula	sem	like ( oswald , ursula )
Oswald likes Winnifred	sem	like ( oswald , winnifred )
Oswald likes Xerxes	sem	like ( oswald , xerxes )
Oswald likes Yvette	sem	like ( oswald , yvettte )
Oswald dislikes Bob	sem	dislike ( oswald , bob )
Oswald dislikes Claire	sem	dislike ( oswald , claire )
Oswald dislikes Eliza	sem	dislike ( oswald , eliza )
Oswald dislikes Francis	sem	dislike ( oswald , francis )
Oswald dislikes Grace	sem	dislike ( oswald , grace )
Oswald dislikes Henry	sem	dislike ( oswald , henry )
Oswald dislikes Isla	sem	dislike ( oswald , isla )
Oswald dislikes John	sem	dislike ( oswald , john )
Oswald dislikes Katherine	sem	dislike ( oswald , katherine )
Oswald dislikes Lewis	sem	dislike ( oswald , lewis )
Oswald dislikes Margaret	sem	dislike ( oswald , margaret )
Oswald dislikes Oswald	sem	dislike ( oswald , oswald )
Oswald dislikes Patricia	sem	dislike ( oswald , patricia )
Oswald dislikes Quinn	sem	dislike ( oswald , quinn )
Oswald dislikes Rachael	sem	dislike ( oswald , rachael )
Oswald dislikes Samuel	sem	dislike ( oswald , samuel )
Oswald dislikes Tracy	sem	dislike ( oswald , tracy )
Oswald dislikes Ursula	sem	dislike ( oswald , ursula )
Oswald dislikes Winnifred	sem	dislike ( oswald , winnifred )
Oswald dislikes Yvette	sem	dislike ( oswald , yvettte )
Oswald dislikes Zelda	sem	dislike ( oswald , zelda )
Oswald throws Bob	sem	throw ( oswald , bob )
Oswald throws Daniel	sem	throw ( oswald , daniel )
Oswald throws Eliza	sem	throw ( oswald , eliza )
Oswald throws John	sem	throw ( oswald , john )
Oswald throws Katherine	sem	throw ( oswald , katherine )
Oswald throws Margaret	sem	throw ( oswald , margaret )
Oswald throws Oswald	sem	throw ( oswald , oswald )
Oswald throws Patricia	sem	throw ( oswald , patricia )
Oswald throws Quinn	sem	throw ( oswald , quinn )
Oswald throws Samuel	sem	throw ( oswald , samuel )
Oswald throws Tracy	sem	throw ( oswald , tracy )
Oswald throws Ursula	sem	throw ( oswald , ursula )
Oswald throws Victor	sem	throw ( oswald , victor )
Oswald throws Winnifred	sem	throw ( oswald , winnifred )
Oswald throws Yvette	sem	throw ( oswald , yvettte )
Oswald throws Zelda	sem	throw ( oswald , zelda )
Oswald notices Bob	sem	notice ( oswald , bob )
Oswald notices Claire	sem	notice ( oswald , claire )
Oswald notices Daniel	sem	notice ( oswald , daniel )
Oswald notices Eliza	sem	notice ( oswald , eliza )
Oswald notices Francis	sem	notice ( oswald , francis )
Oswald notices Grace	sem	notice ( oswald , grace )
Oswald notices Henry	sem	notice ( oswald , henry )
Oswald notices Isla	sem	notice ( oswald , isla )
Oswald notices John	sem	notice ( oswald , john )
Oswald notices Katherine	sem	notice ( oswald , katherine )
Oswald notices Lewis	sem	notice ( oswald , lewis )
Oswald notices Neha	sem	notice ( oswald , neha )
Oswald notices Oswald	sem	notice ( oswald , oswald )
Oswald notices Patricia	sem	notice ( oswald , patricia )
Oswald notices Rachael	sem	notice ( oswald , rachael )
Oswald notices Samuel	sem	notice ( oswald , samuel )
Oswald notices Tracy	sem	notice ( oswald , tracy )
Oswald notices Ursula	sem	notice ( oswald , ursula )
Oswald notices Victor	sem	notice ( oswald , victor )
Oswald notices Xerxes	sem	notice ( oswald , xerxes )
Oswald notices Yvette	sem	notice ( oswald , yvettte )
Oswald notices Zelda	sem	notice ( oswald , zelda )
Oswald knows Claire	sem	know ( oswald , claire )
Oswald knows Daniel	sem	know ( oswald , daniel )
Oswald knows Eliza	sem	know ( oswald , eliza )
Oswald knows Francis	sem	know ( oswald , francis )
Oswald knows Grace	sem	know ( oswald , grace )
Oswald knows Henry	sem	know ( oswald , henry )
Oswald knows Isla	sem	know ( oswald , isla )
Oswald knows John	sem	know ( oswald , john )
Oswald knows Katherine	sem	know ( oswald , katherine )
Oswald knows Lewis	sem	know ( oswald , lewis )
Oswald knows Margaret	sem	know ( oswald , margaret )
Oswald knows Neha	sem	know ( oswald , neha )
Oswald knows Oswald	sem	know ( oswald , oswald )
Oswald knows Patricia	sem	know ( oswald , patricia )
Oswald knows Quinn	sem	know ( oswald , quinn )
Oswald knows Samuel	sem	know ( oswald , samuel )
Oswald knows Tracy	sem	know ( oswald , tracy )
Oswald knows Ursula	sem	know ( oswald , ursula )
Oswald knows Victor	sem	know ( oswald , victor )
Oswald knows Yvette	sem	know ( oswald , yvettte )
Oswald likes himself	sem	like ( oswald , oswald )
Oswald dislikes himself	sem	dislike ( oswald , oswald )
Oswald throws himself	sem	throw ( oswald , oswald )
Oswald notices himself	sem	notice ( oswald , oswald )
Oswald knows himself	sem	know ( oswald , oswald )
Patricia walks	sem	walk ( patricia )
Patricia sleeps	sem	sleep ( patricia )
Patricia eats	sem	eat ( patricia )
Patricia runs	sem	run ( patricia )
Patricia sings	sem	sing ( patricia )
Patricia dances	sem	dance ( patricia )
Patricia flies	sem	fly ( patricia )
Patricia slumbers	sem	slumber ( patricia )
Patricia sees Bob	sem	see ( patricia , bob )
Patricia sees Claire	sem	see ( patricia , claire )
Patricia sees Daniel	sem	see ( patricia , daniel )
Patricia sees Eliza	sem	see ( patricia , eliza )
Patricia sees Francis	sem	see ( patricia , francis )
Patricia sees Henry	sem	see ( patricia , henry )
Patricia sees Isla	sem	see ( patricia , isla )
Patricia sees John	sem	see ( patricia , john )
Patricia sees Katherine	sem	see ( patricia , katherine )
Patricia sees Lewis	sem	see ( patricia , lewis )
Patricia sees Margaret	sem	see ( patricia , margaret )
Patricia sees Neha	sem	see ( patricia , neha )
Patricia sees Oswald	sem	see ( patricia , oswald )
Patricia sees Patricia	sem	see ( patricia , patricia )
Patricia sees Quinn	sem	see ( patricia , quinn )
Patricia sees Rachael	sem	see ( patricia , rachael )
Patricia sees Tracy	sem	see ( patricia , tracy )
Patricia sees Ursula	sem	see ( patricia , ursula )
Patricia sees Victor	sem	see ( patricia , victor )
Patricia sees Winnifred	sem	see ( patricia , winnifred )
Patricia sees Zelda	sem	see ( patricia , zelda )
Patricia meets Daniel	sem	meet ( patricia , daniel )
Patricia meets Eliza	sem	meet ( patricia , eliza )
Patricia meets Francis	sem	meet ( patricia , francis )
Patricia meets Grace	sem	meet ( patricia , grace )
Patricia meets Henry	sem	meet ( patricia , henry )
Patricia meets Isla	sem	meet ( patricia , isla )
Patricia meets John	sem	meet ( patricia , john )
Patricia meets Katherine	sem	meet ( patricia , katherine )
Patricia meets Lewis	sem	meet ( patricia , lewis )
Patricia meets Margaret	sem	meet ( patricia , margaret )
Patricia meets Neha	sem	meet ( patricia , neha )
Patricia meets Oswald	sem	meet ( patricia , oswald )
Patricia meets Patricia	sem	meet ( patricia , patricia )
Patricia meets Quinn	sem	meet ( patricia , quinn )
Patricia meets Rachael	sem	meet ( patricia , rachael )
Patricia meets Samuel	sem	meet ( patricia , samuel )
Patricia meets Tracy	sem	meet ( patricia , tracy )
Patricia meets Ursula	sem	meet ( patricia , ursula )
Patricia meets Victor	sem	meet ( patricia , victor )
Patricia meets Winnifred	sem	meet ( patricia , winnifred )
Patricia meets Xerxes	sem	meet ( patricia , xerxes )
Patricia meets Yvette	sem	meet ( patricia , yvettte )
Patricia meets Zelda	sem	meet ( patricia , zelda )
Patricia likes Claire	sem	like ( patricia , claire )
Patricia likes Daniel	sem	like ( patricia , daniel )
Patricia likes Eliza	sem	like ( patricia , eliza )
Patricia likes Francis	sem	like ( patricia , francis )
Patricia likes Grace	sem	like ( patricia , grace )
Patricia likes Henry	sem	like ( patricia , henry )
Patricia likes Isla	sem	like ( patricia , isla )
Patricia likes Katherine	sem	like ( patricia , katherine )
Patricia likes Lewis	sem	like ( patricia , lewis )
Patricia likes Margaret	sem	like ( patricia , margaret )
Patricia likes Neha	sem	like ( patricia , neha )
Patricia likes Patricia	sem	like ( patricia , patricia )
Patricia likes Quinn	sem	like ( patricia , quinn )
Patricia likes Rachael	sem	like ( patricia , rachael )
Patricia likes Samuel	sem	like ( patricia , samuel )
Patricia likes Tracy	sem	like ( patricia , tracy )
Patricia likes Ursula	sem	like ( patricia , ursula )
Patricia likes Victor	sem	like ( patricia , victor )
Patricia likes Xerxes	sem	like ( patricia , xerxes )
Patricia likes Yvette	sem	like ( patricia , yvettte )
Patricia dislikes Claire	sem	dislike ( patricia , claire )
Patricia dislikes Daniel	sem	dislike ( patricia , daniel )
Patricia dislikes Eliza	sem	dislike ( patricia , eliza )
Patricia dislikes Francis	sem	dislike ( patricia , francis )
Patricia dislikes Grace	sem	dislike ( patricia , grace )
Patricia dislikes Henry	sem	dislike ( patricia , henry )
Patricia dislikes Isla	sem	dislike ( patricia , isla )
Patricia dislikes John	sem	dislike ( patricia , john )
Patricia dislikes Katherine	sem	dislike ( patricia , katherine )
Patricia dislikes Lewis	sem	dislike ( patricia , lewis )
Patricia dislikes Margaret	sem	dislike ( patricia , margaret )
Patricia dislikes Neha	sem	dislike ( patricia , neha )
Patricia dislikes Oswald	sem	dislike ( patricia , oswald )
Patricia dislikes Patricia	sem	dislike ( patricia , patricia )
Patricia dislikes Quinn	sem	dislike ( patricia , quinn )
Patricia dislikes Tracy	sem	dislike ( patricia , tracy )
Patricia dislikes Victor	sem	dislike ( patricia , victor )
Patricia dislikes Winnifred	sem	dislike ( patricia , winnifred )
Patricia dislikes Xerxes	sem	dislike ( patricia , xerxes )
Patricia dislikes Zelda	sem	dislike ( patricia , zelda )
Patricia throws Claire	sem	throw ( patricia , claire )
Patricia throws Daniel	sem	throw ( patricia , daniel )
Patricia throws Eliza	sem	throw ( patricia , eliza )
Patricia throws Francis	sem	throw ( patricia , francis )
Patricia throws Grace	sem	throw ( patricia , grace )
Patricia throws Henry	sem	throw ( patricia , henry )
Patricia throws Isla	sem	throw ( patricia , isla )
Patricia throws John	sem	throw ( patricia , john )
Patricia throws Katherine	sem	throw ( patricia , katherine )
Patricia throws Margaret	sem	throw ( patricia , margaret )
Patricia throws Neha	sem	throw ( patricia , neha )
Patricia throws Oswald	sem	throw ( patricia , oswald )
Patricia throws Patricia	sem	throw ( patricia , patricia )
Patricia throws Quinn	sem	throw ( patricia , quinn )
Patricia throws Rachael	sem	throw ( patricia , rachael )
Patricia throws Samuel	sem	throw ( patricia , samuel )
Patricia throws Tracy	sem	throw ( patricia , tracy )
Patricia throws Victor	sem	throw ( patricia , victor )
Patricia throws Winnifred	sem	throw ( patricia , winnifred )
Patricia throws Yvette	sem	throw ( patricia , yvettte )
Patricia throws Zelda	sem	throw ( patricia , zelda )
Patricia notices Daniel	sem	notice ( patricia , daniel )
Patricia notices Eliza	sem	notice ( patricia , eliza )
Patricia notices Grace	sem	notice ( patricia , grace )
Patricia notices Isla	sem	notice ( patricia , isla )
Patricia notices John	sem	notice ( patricia , john )
Patricia notices Katherine	sem	notice ( patricia , katherine )
Patricia notices Lewis	sem	notice ( patricia , lewis )
Patricia notices Margaret	sem	notice ( patricia , margaret )
Patricia notices Oswald	sem	notice ( patricia , oswald )
Patricia notices Patricia	sem	notice ( patricia , patricia )
Patricia notices Quinn	sem	notice ( patricia , quinn )
Patricia notices Tracy	sem	notice ( patricia , tracy )
Patricia notices Victor	sem	notice ( patricia , victor )
Patricia notices Xerxes	sem	notice ( patricia , xerxes )
Patricia notices Yvette	sem	notice ( patricia , yvettte )
Patricia notices Zelda	sem	notice ( patricia , zelda )
Patricia knows Bob	sem	know ( patricia , bob )
Patricia knows Claire	sem	know ( patricia , claire )
Patricia knows Daniel	sem	know ( patricia , daniel )
Patricia knows Eliza	sem	know ( patricia , eliza )
Patricia knows Grace	sem	know ( patricia , grace )
Patricia knows Henry	sem	know ( patricia , henry )
Patricia knows Isla	sem	know ( patricia , isla )
Patricia knows John	sem	know ( patricia , john )
Patricia knows Katherine	sem	know ( patricia , katherine )
Patricia knows Lewis	sem	know ( patricia , lewis )
Patricia knows Oswald	sem	know ( patricia , oswald )
Patricia knows Quinn	sem	know ( patricia , quinn )
Patricia knows Rachael	sem	know ( patricia , rachael )
Patricia knows Samuel	sem	know ( patricia , samuel )
Patricia knows Tracy	sem	know ( patricia , tracy )
Patricia knows Ursula	sem	know ( patricia , ursula )
Patricia knows Victor	sem	know ( patricia , victor )
Patricia knows Winnifred	sem	know ( patricia , winnifred )
Patricia knows Xerxes	sem	know ( patricia , xerxes )
Patricia knows Yvette	sem	know ( patricia , yvettte )
Patricia knows Zelda	sem	know ( patricia , zelda )
Patricia sees herself	sem	see ( patricia , patricia )
Patricia meets herself	sem	meet ( patricia , patricia )
Patricia likes herself	sem	like ( patricia , patricia )
Patricia throws herself	sem	throw ( patricia , patricia )
Patricia notices herself	sem	notice ( patricia , patricia )
Patricia knows herself	sem	know ( patricia , patricia )
Quinn walks	sem	walk ( quinn )
Quinn sleeps	sem	sleep ( quinn )
Quinn sings	sem	sing ( quinn )
Quinn flies	sem	fly ( quinn )
Quinn slumbers	sem	slumber ( quinn )
Quinn sees Bob	sem	see ( quinn , bob )
Quinn sees Daniel	sem	see ( quinn , daniel )
Quinn sees Eliza	sem	see ( quinn , eliza )
Quinn sees Francis	sem	see ( quinn , francis )
Quinn sees Grace	sem	see ( quinn , grace )
Quinn sees Henry	sem	see ( quinn , henry )
Quinn sees Isla	sem	see ( quinn , isla )
Quinn sees Katherine	sem	see ( quinn , katherine )
Quinn sees Lewis	sem	see ( quinn , lewis )
Quinn sees Margaret	sem	see ( quinn , margaret )
Quinn sees Neha	sem	see ( quinn , neha )
Quinn sees Oswald	sem	see ( quinn , oswald )
Quinn sees Patricia	sem	see ( quinn , patricia )
Quinn sees Rachael	sem	see ( quinn , rachael )
Quinn sees Tracy	sem	see ( quinn , tracy )
Quinn sees Ursula	sem	see ( quinn , ursula )
Quinn sees Victor	sem	see ( quinn , victor )
Quinn sees Winnifred	sem	see ( quinn , winnifred )
Quinn sees Yvette	sem	see ( quinn , yvettte )
Quinn sees Zelda	sem	see ( quinn , zelda )
Quinn meets Bob	sem	meet ( quinn , bob )
Quinn meets Claire	sem	meet ( quinn , claire )
Quinn meets Daniel	sem	meet ( quinn , daniel )
Quinn meets Eliza	sem	meet ( quinn , eliza )
Quinn meets Grace	sem	meet ( quinn , grace )
Quinn meets Henry	sem	meet ( quinn , henry )
Quinn meets Isla	sem	meet ( quinn , isla )
Quinn meets Katherine	sem	meet ( quinn , katherine )
Quinn meets Lewis	sem	meet ( quinn , lewis )
Quinn meets Margaret	sem	meet ( quinn , margaret )
Quinn meets Neha	sem	meet ( quinn , neha )
Quinn meets Oswald	sem	meet ( quinn , oswald )
Quinn meets Quinn	sem	meet ( quinn , quinn )
Quinn meets Samuel	sem	meet ( quinn , samuel )
Quinn meets Tracy	sem	meet ( quinn , tracy )
Quinn meets Ursula	sem	meet ( quinn , ursula )
Quinn meets Victor	sem	meet ( quinn , victor )
Quinn meets Winnifred	sem	meet ( quinn , winnifred )
Quinn meets Xerxes	sem	meet ( quinn , xerxes )
Quinn meets Yvette	sem	meet ( quinn , yvettte )
Quinn meets Zelda	sem	meet ( quinn , zelda )
Quinn likes Bob	sem	like ( quinn , bob )
Quinn likes Claire	sem	like ( quinn , claire )
Quinn likes Daniel	sem	like ( quinn , daniel )
Quinn likes Francis	sem	like ( quinn , francis )
Quinn likes Grace	sem	like ( quinn , grace )
Quinn likes Katherine	sem	like ( quinn , katherine )
Quinn likes Lewis	sem	like ( quinn , lewis )
Quinn likes Neha	sem	like ( quinn , neha )
Quinn likes Patricia	sem	like ( quinn , patricia )
Quinn likes Quinn	sem	like ( quinn , quinn )
Quinn likes Rachael	sem	like ( quinn , rachael )
Quinn likes Samuel	sem	like ( quinn , samuel )
Quinn likes Tracy	sem	like ( quinn , tracy )
Quinn likes Ursula	sem	like ( quinn , ursula )
Quinn likes Victor	sem	like ( quinn , victor )
Quinn likes Winnifred	sem	like ( quinn , winnifred )
Quinn likes Xerxes	sem	like ( quinn , xerxes )
Quinn likes Yvette	sem	like ( quinn , yvettte )
Quinn likes Zelda	sem	like ( quinn , zelda )
Quinn dislikes Claire	sem	dislike ( quinn , claire )
Quinn dislikes Daniel	sem	dislike ( quinn , daniel )
Quinn dislikes Eliza	sem	dislike ( quinn , eliza )
Quinn dislikes Francis	sem	dislike ( quinn , francis )
Quinn dislikes Grace	sem	dislike ( quinn , grace )
Quinn dislikes Henry	sem	dislike ( quinn , henry )
Quinn dislikes Isla	sem	dislike ( quinn , isla )
Quinn dislikes Lewis	sem	dislike ( quinn , lewis )
Quinn dislikes Neha	sem	dislike ( quinn , neha )
Quinn dislikes Patricia	sem	dislike ( quinn , patricia )
Quinn dislikes Quinn	sem	dislike ( quinn , quinn )
Quinn dislikes Rachael	sem	dislike ( quinn , rachael )
Quinn dislikes Samuel	sem	dislike ( quinn , samuel )
Quinn dislikes Tracy	sem	dislike ( quinn , tracy )
Quinn dislikes Ursula	sem	dislike ( quinn , ursula )
Quinn dislikes Victor	sem	dislike ( quinn , victor )
Quinn dislikes Xerxes	sem	dislike ( quinn , xerxes )
Quinn dislikes Zelda	sem	dislike ( quinn , zelda )
Quinn throws Bob	sem	throw ( quinn , bob )
Quinn throws Claire	sem	throw ( quinn , claire )
Quinn throws Eliza	sem	throw ( quinn , eliza )
Quinn throws Francis	sem	throw ( quinn , francis )
Quinn throws Grace	sem	throw ( quinn , grace )
Quinn throws Henry	sem	throw ( quinn , henry )
Quinn throws Isla	sem	throw ( quinn , isla )
Quinn throws John	sem	throw ( quinn , john )
Quinn throws Katherine	sem	throw ( quinn , katherine )
Quinn throws Lewis	sem	throw ( quinn , lewis )
Quinn throws Margaret	sem	throw ( quinn , margaret )
Quinn throws Neha	sem	throw ( quinn , neha )
Quinn throws Patricia	sem	throw ( quinn , patricia )
Quinn throws Quinn	sem	throw ( quinn , quinn )
Quinn throws Rachael	sem	throw ( quinn , rachael )
Quinn throws Samuel	sem	throw ( quinn , samuel )
Quinn throws Tracy	sem	throw ( quinn , tracy )
Quinn throws Ursula	sem	throw ( quinn , ursula )
Quinn throws Victor	sem	throw ( quinn , victor )
Quinn notices Claire	sem	notice ( quinn , claire )
Quinn notices Daniel	sem	notice ( quinn , daniel )
Quinn notices Eliza	sem	notice ( quinn , eliza )
Quinn notices Francis	sem	notice ( quinn , francis )
Quinn notices Grace	sem	notice ( quinn , grace )
Quinn notices Henry	sem	notice ( quinn , henry )
Quinn notices Isla	sem	notice ( quinn , isla )
Quinn notices John	sem	notice ( quinn , john )
Quinn notices Katherine	sem	notice ( quinn , katherine )
Quinn notices Lewis	sem	notice ( quinn , lewis )
Quinn notices Margaret	sem	notice ( quinn , margaret )
Quinn notices Neha	sem	notice ( quinn , neha )
Quinn notices Oswald	sem	notice ( quinn , oswald )
Quinn notices Quinn	sem	notice ( quinn , quinn )
Quinn notices Rachael	sem	notice ( quinn , rachael )
Quinn notices Samuel	sem	notice ( quinn , samuel )
Quinn notices Tracy	sem	notice ( quinn , tracy )
Quinn notices Ursula	sem	notice ( quinn , ursula )
Quinn notices Winnifred	sem	notice ( quinn , winnifred )
Quinn notices Xerxes	sem	notice ( quinn , xerxes )
Quinn notices Yvette	sem	notice ( quinn , yvettte )
Quinn notices Zelda	sem	notice ( quinn , zelda )
Quinn knows Bob	sem	know ( quinn , bob )
Quinn knows Claire	sem	know ( quinn , claire )
Quinn knows Daniel	sem	know ( quinn , daniel )
Quinn knows Eliza	sem	know ( quinn , eliza )
Quinn knows Henry	sem	know ( quinn , henry )
Quinn knows Isla	sem	know ( quinn , isla )
Quinn knows John	sem	know ( quinn , john )
Quinn knows Margaret	sem	know ( quinn , margaret )
Quinn knows Neha	sem	know ( quinn , neha )
Quinn knows Oswald	sem	know ( quinn , oswald )
Quinn knows Quinn	sem	know ( quinn , quinn )
Quinn knows Rachael	sem	know ( quinn , rachael )
Quinn knows Samuel	sem	know ( quinn , samuel )
Quinn knows Tracy	sem	know ( quinn , tracy )
Quinn knows Ursula	sem	know ( quinn , ursula )
Quinn knows Victor	sem	know ( quinn , victor )
Quinn knows Winnifred	sem	know ( quinn , winnifred )
Quinn knows Xerxes	sem	know ( quinn , xerxes )
Quinn knows Yvette	sem	know ( quinn , yvettte )
Quinn sees himself	sem	see ( quinn , quinn )
Quinn meets himself	sem	meet ( quinn , quinn )
Quinn likes himself	sem	like ( quinn , quinn )
Quinn throws himself	sem	throw ( quinn , quinn )
Quinn notices himself	sem	notice ( quinn , quinn )
Quinn knows himself	sem	know ( quinn , quinn )
Rachael walks	sem	walk ( rachael )
Rachael eats	sem	eat ( rachael )
Rachael dances	sem	dance ( rachael )
Rachael slumbers	sem	slumber ( rachael )
Rachael sees Bob	sem	see ( rachael , bob )
Rachael sees Claire	sem	see ( rachael , claire )
Rachael sees Daniel	sem	see ( rachael , daniel )
Rachael sees Eliza	sem	see ( rachael , eliza )
Rachael sees Francis	sem	see ( rachael , francis )
Rachael sees Grace	sem	see ( rachael , grace )
Rachael sees Henry	sem	see ( rachael , henry )
Rachael sees Isla	sem	see ( rachael , isla )
Rachael sees John	sem	see ( rachael , john )
Rachael sees Katherine	sem	see ( rachael , katherine )
Rachael sees Neha	sem	see ( rachael , neha )
Rachael sees Oswald	sem	see ( rachael , oswald )
Rachael sees Patricia	sem	see ( rachael , patricia )
Rachael sees Samuel	sem	see ( rachael , samuel )
Rachael sees Tracy	sem	see ( rachael , tracy )
Rachael sees Ursula	sem	see ( rachael , ursula )
Rachael sees Victor	sem	see ( rachael , victor )
Rachael sees Winnifred	sem	see ( rachael , winnifred )
Rachael sees Xerxes	sem	see ( rachael , xerxes )
Rachael sees Zelda	sem	see ( rachael , zelda )
Rachael meets Bob	sem	meet ( rachael , bob )
Rachael meets Claire	sem	meet ( rachael , claire )
Rachael meets Daniel	sem	meet ( rachael , daniel )
Rachael meets Eliza	sem	meet ( rachael , eliza )
Rachael meets Francis	sem	meet ( rachael , francis )
Rachael meets John	sem	meet ( rachael , john )
Rachael meets Katherine	sem	meet ( rachael , katherine )
Rachael meets Margaret	sem	meet ( rachael , margaret )
Rachael meets Neha	sem	meet ( rachael , neha )
Rachael meets Oswald	sem	meet ( rachael , oswald )
Rachael meets Rachael	sem	meet ( rachael , rachael )
Rachael meets Samuel	sem	meet ( rachael , samuel )
Rachael meets Tracy	sem	meet ( rachael , tracy )
Rachael meets Ursula	sem	meet ( rachael , ursula )
Rachael meets Victor	sem	meet ( rachael , victor )
Rachael meets Xerxes	sem	meet ( rachael , xerxes )
Rachael meets Zelda	sem	meet ( rachael , zelda )
Rachael likes Bob	sem	like ( rachael , bob )
Rachael likes Claire	sem	like ( rachael , claire )
Rachael likes Daniel	sem	like ( rachael , daniel )
Rachael likes Eliza	sem	like ( rachael , eliza )
Rachael likes Francis	sem	like ( rachael , francis )
Rachael likes Grace	sem	like ( rachael , grace )
Rachael likes Henry	sem	like ( rachael , henry )
Rachael likes Isla	sem	like ( rachael , isla )
Rachael likes John	sem	like ( rachael , john )
Rachael likes Katherine	sem	like ( rachael , katherine )
Rachael likes Lewis	sem	like ( rachael , lewis )
Rachael likes Margaret	sem	like ( rachael , margaret )
Rachael likes Neha	sem	like ( rachael , neha )
Rachael likes Oswald	sem	like ( rachael , oswald )
Rachael likes Patricia	sem	like ( rachael , patricia )
Rachael likes Quinn	sem	like ( rachael , quinn )
Rachael likes Samuel	sem	like ( rachael , samuel )
Rachael likes Tracy	sem	like ( rachael , tracy )
Rachael likes Ursula	sem	like ( rachael , ursula )
Rachael likes Victor	sem	like ( rachael , victor )
Rachael likes Winnifred	sem	like ( rachael , winnifred )
Rachael likes Xerxes	sem	like ( rachael , xerxes )
Rachael likes Yvette	sem	like ( rachael , yvettte )
Rachael dislikes Bob	sem	dislike ( rachael , bob )
Rachael dislikes Claire	sem	dislike ( rachael , claire )
Rachael dislikes Daniel	sem	dislike ( rachael , daniel )
Rachael dislikes Eliza	sem	dislike ( rachael , eliza )
Rachael dislikes Grace	sem	dislike ( rachael , grace )
Rachael dislikes Henry	sem	dislike ( rachael , henry )
Rachael dislikes Isla	sem	dislike ( rachael , isla )
Rachael dislikes John	sem	dislike ( rachael , john )
Rachael dislikes Lewis	sem	dislike ( rachael , lewis )
Rachael dislikes Margaret	sem	dislike ( rachael , margaret )
Rachael dislikes Neha	sem	dislike ( rachael , neha )
Rachael dislikes Patricia	sem	dislike ( rachael , patricia )
Rachael dislikes Quinn	sem	dislike ( rachael , quinn )
Rachael dislikes Rachael	sem	dislike ( rachael , rachael )
Rachael dislikes Samuel	sem	dislike ( rachael , samuel )
Rachael dislikes Tracy	sem	dislike ( rachael , tracy )
Rachael dislikes Ursula	sem	dislike ( rachael , ursula )
Rachael dislikes Winnifred	sem	dislike ( rachael , winnifred )
Rachael dislikes Yvette	sem	dislike ( rachael , yvettte )
Rachael throws Claire	sem	throw ( rachael , claire )
Rachael throws Daniel	sem	throw ( rachael , daniel )
Rachael throws Eliza	sem	throw ( rachael , eliza )
Rachael throws Francis	sem	throw ( rachael , francis )
Rachael throws Grace	sem	throw ( rachael , grace )
Rachael throws Henry	sem	throw ( rachael , henry )
Rachael throws Isla	sem	throw ( rachael , isla )
Rachael throws John	sem	throw ( rachael , john )
Rachael throws Katherine	sem	throw ( rachael , katherine )
Rachael throws Margaret	sem	throw ( rachael , margaret )
Rachael throws Neha	sem	throw ( rachael , neha )
Rachael throws Oswald	sem	throw ( rachael , oswald )
Rachael throws Patricia	sem	throw ( rachael , patricia )
Rachael throws Quinn	sem	throw ( rachael , quinn )
Rachael throws Rachael	sem	throw ( rachael , rachael )
Rachael throws Samuel	sem	throw ( rachael , samuel )
Rachael throws Ursula	sem	throw ( rachael , ursula )
Rachael throws Victor	sem	throw ( rachael , victor )
Rachael throws Winnifred	sem	throw ( rachael , winnifred )
Rachael throws Yvette	sem	throw ( rachael , yvettte )
Rachael notices Bob	sem	notice ( rachael , bob )
Rachael notices Claire	sem	notice ( rachael , claire )
Rachael notices Daniel	sem	notice ( rachael , daniel )
Rachael notices Eliza	sem	notice ( rachael , eliza )
Rachael notices Francis	sem	notice ( rachael , francis )
Rachael notices Grace	sem	notice ( rachael , grace )
Rachael notices Henry	sem	notice ( rachael , henry )
Rachael notices Isla	sem	notice ( rachael , isla )
Rachael notices John	sem	notice ( rachael , john )
Rachael notices Katherine	sem	notice ( rachael , katherine )
Rachael notices Lewis	sem	notice ( rachael , lewis )
Rachael notices Margaret	sem	notice ( rachael , margaret )
Rachael notices Neha	sem	notice ( rachael , neha )
Rachael notices Patricia	sem	notice ( rachael , patricia )
Rachael notices Rachael	sem	notice ( rachael , rachael )
Rachael notices Samuel	sem	notice ( rachael , samuel )
Rachael notices Tracy	sem	notice ( rachael , tracy )
Rachael notices Victor	sem	notice ( rachael , victor )
Rachael notices Winnifred	sem	notice ( rachael , winnifred )
Rachael notices Xerxes	sem	notice ( rachael , xerxes )
Rachael notices Yvette	sem	notice ( rachael , yvettte )
Rachael notices Zelda	sem	notice ( rachael , zelda )
Rachael knows Bob	sem	know ( rachael , bob )
Rachael knows Claire	sem	know ( rachael , claire )
Rachael knows Daniel	sem	know ( rachael , daniel )
Rachael knows Eliza	sem	know ( rachael , eliza )
Rachael knows Henry	sem	know ( rachael , henry )
Rachael knows Isla	sem	know ( rachael , isla )
Rachael knows Katherine	sem	know ( rachael , katherine )
Rachael knows Lewis	sem	know ( rachael , lewis )
Rachael knows Margaret	sem	know ( rachael , margaret )
Rachael knows Oswald	sem	know ( rachael , oswald )
Rachael knows Patricia	sem	know ( rachael , patricia )
Rachael knows Quinn	sem	know ( rachael , quinn )
Rachael knows Samuel	sem	know ( rachael , samuel )
Rachael knows Ursula	sem	know ( rachael , ursula )
Rachael knows Victor	sem	know ( rachael , victor )
Rachael knows Winnifred	sem	know ( rachael , winnifred )
Rachael knows Xerxes	sem	know ( rachael , xerxes )
Rachael knows Yvette	sem	know ( rachael , yvettte )
Rachael knows Zelda	sem	know ( rachael , zelda )
Rachael sees herself	sem	see ( rachael , rachael )
Rachael meets herself	sem	meet ( rachael , rachael )
Rachael likes herself	sem	like ( rachael , rachael )
Rachael dislikes herself	sem	dislike ( rachael , rachael )
Rachael throws herself	sem	throw ( rachael , rachael )
Rachael notices herself	sem	notice ( rachael , rachael )
Rachael knows herself	sem	know ( rachael , rachael )
Samuel sleeps	sem	sleep ( samuel )
Samuel eats	sem	eat ( samuel )
Samuel runs	sem	run ( samuel )
Samuel dances	sem	dance ( samuel )
Samuel flies	sem	fly ( samuel )
Samuel slumbers	sem	slumber ( samuel )
Samuel sees Claire	sem	see ( samuel , claire )
Samuel sees Daniel	sem	see ( samuel , daniel )
Samuel sees Francis	sem	see ( samuel , francis )
Samuel sees Henry	sem	see ( samuel , henry )
Samuel sees John	sem	see ( samuel , john )
Samuel sees Katherine	sem	see ( samuel , katherine )
Samuel sees Margaret	sem	see ( samuel , margaret )
Samuel sees Oswald	sem	see ( samuel , oswald )
Samuel sees Quinn	sem	see ( samuel , quinn )
Samuel sees Rachael	sem	see ( samuel , rachael )
Samuel sees Samuel	sem	see ( samuel , samuel )
Samuel sees Ursula	sem	see ( samuel , ursula )
Samuel sees Victor	sem	see ( samuel , victor )
Samuel sees Winnifred	sem	see ( samuel , winnifred )
Samuel sees Yvette	sem	see ( samuel , yvettte )
Samuel sees Zelda	sem	see ( samuel , zelda )
Samuel meets Bob	sem	meet ( samuel , bob )
Samuel meets Eliza	sem	meet ( samuel , eliza )
Samuel meets Francis	sem	meet ( samuel , francis )
Samuel meets Grace	sem	meet ( samuel , grace )
Samuel meets Henry	sem	meet ( samuel , henry )
Samuel meets Isla	sem	meet ( samuel , isla )
Samuel meets John	sem	meet ( samuel , john )
Samuel meets Katherine	sem	meet ( samuel , katherine )
Samuel meets Lewis	sem	meet ( samuel , lewis )
Samuel meets Margaret	sem	meet ( samuel , margaret )
Samuel meets Neha	sem	meet ( samuel , neha )
Samuel meets Patricia	sem	meet ( samuel , patricia )
Samuel meets Quinn	sem	meet ( samuel , quinn )
Samuel meets Rachael	sem	meet ( samuel , rachael )
Samuel meets Samuel	sem	meet ( samuel , samuel )
Samuel meets Tracy	sem	meet ( samuel , tracy )
Samuel meets Ursula	sem	meet ( samuel , ursula )
Samuel meets Victor	sem	meet ( samuel , victor )
Samuel meets Winnifred	sem	meet ( samuel , winnifred )
Samuel meets Zelda	sem	meet ( samuel , zelda )
Samuel likes Bob	sem	like ( samuel , bob )
Samuel likes Henry	sem	like ( samuel , henry )
Samuel likes John	sem	like ( samuel , john )
Samuel likes Katherine	sem	like ( samuel , katherine )
Samuel likes Lewis	sem	like ( samuel , lewis )
Samuel likes Margaret	sem	like ( samuel , margaret )
Samuel likes Neha	sem	like ( samuel , neha )
Samuel likes Oswald	sem	like ( samuel , oswald )
Samuel likes Quinn	sem	like ( samuel , quinn )
Samuel likes Rachael	sem	like ( samuel , rachael )
Samuel likes Samuel	sem	like ( samuel , samuel )
Samuel likes Tracy	sem	like ( samuel , tracy )
Samuel likes Ursula	sem	like ( samuel , ursula )
Samuel likes Victor	sem	like ( samuel , victor )
Samuel likes Winnifred	sem	like ( samuel , winnifred )
Samuel likes Yvette	sem	like ( samuel , yvettte )
Samuel likes Zelda	sem	like ( samuel , zelda )
Samuel dislikes Bob	sem	dislike ( samuel , bob )
Samuel dislikes Claire	sem	dislike ( samuel , claire )
Samuel dislikes Daniel	sem	dislike ( samuel , daniel )
Samuel dislikes Eliza	sem	dislike ( samuel , eliza )
Samuel dislikes Francis	sem	dislike ( samuel , francis )
Samuel dislikes Grace	sem	dislike ( samuel , grace )
Samuel dislikes Henry	sem	dislike ( samuel , henry )
Samuel dislikes Isla	sem	dislike ( samuel , isla )
Samuel dislikes John	sem	dislike ( samuel , john )
Samuel dislikes Lewis	sem	dislike ( samuel , lewis )
Samuel dislikes Margaret	sem	dislike ( samuel , margaret )
Samuel dislikes Neha	sem	dislike ( samuel , neha )
Samuel dislikes Oswald	sem	dislike ( samuel , oswald )
Samuel dislikes Patricia	sem	dislike ( samuel , patricia )
Samuel dislikes Quinn	sem	dislike ( samuel , quinn )
Samuel dislikes Rachael	sem	dislike ( samuel , rachael )
Samuel dislikes Samuel	sem	dislike ( samuel , samuel )
Samuel dislikes Tracy	sem	dislike ( samuel , tracy )
Samuel dislikes Ursula	sem	dislike ( samuel , ursula )
Samuel dislikes Victor	sem	dislike ( samuel , victor )
Samuel dislikes Winnifred	sem	dislike ( samuel , winnifred )
Samuel dislikes Xerxes	sem	dislike ( samuel , xerxes )
Samuel dislikes Yvette	sem	dislike ( samuel , yvettte )
Samuel dislikes Zelda	sem	dislike ( samuel , zelda )
Samuel throws Bob	sem	throw ( samuel , bob )
Samuel throws Daniel	sem	throw ( samuel , daniel )
Samuel throws Eliza	sem	throw ( samuel , eliza )
Samuel throws Francis	sem	throw ( samuel , francis )
Samuel throws Grace	sem	throw ( samuel , grace )
Samuel throws Henry	sem	throw ( samuel , henry )
Samuel throws Isla	sem	throw ( samuel , isla )
Samuel throws John	sem	throw ( samuel , john )
Samuel throws Katherine	sem	throw ( samuel , katherine )
Samuel throws Lewis	sem	throw ( samuel , lewis )
Samuel throws Margaret	sem	throw ( samuel , margaret )
Samuel throws Neha	sem	throw ( samuel , neha )
Samuel throws Oswald	sem	throw ( samuel , oswald )
Samuel throws Rachael	sem	throw ( samuel , rachael )
Samuel throws Samuel	sem	throw ( samuel , samuel )
Samuel throws Tracy	sem	throw ( samuel , tracy )
Samuel throws Ursula	sem	throw ( samuel , ursula )
Samuel throws Winnifred	sem	throw ( samuel , winnifred )
Samuel throws Xerxes	sem	throw ( samuel , xerxes )
Samuel throws Yvette	sem	throw ( samuel , yvettte )
Samuel throws Zelda	sem	throw ( samuel , zelda )
Samuel notices Bob	sem	notice ( samuel , bob )
Samuel notices Claire	sem	notice ( samuel , claire )
Samuel notices Daniel	sem	notice ( samuel , daniel )
Samuel notices Eliza	sem	notice ( samuel , eliza )
Samuel notices Francis	sem	notice ( samuel , francis )
Samuel notices Grace	sem	notice ( samuel , grace )
Samuel notices Isla	sem	notice ( samuel , isla )
Samuel notices John	sem	notice ( samuel , john )
Samuel notices Katherine	sem	notice ( samuel , katherine )
Samuel notices Lewis	sem	notice ( samuel , lewis )
Samuel notices Margaret	sem	notice ( samuel , margaret )
Samuel notices Neha	sem	notice ( samuel , neha )
Samuel notices Patricia	sem	notice ( samuel , patricia )
Samuel notices Quinn	sem	notice ( samuel , quinn )
Samuel notices Rachael	sem	notice ( samuel , rachael )
Samuel notices Samuel	sem	notice ( samuel , samuel )
Samuel notices Ursula	sem	notice ( samuel , ursula )
Samuel notices Victor	sem	notice ( samuel , victor )
Samuel notices Winnifred	sem	notice ( samuel , winnifred )
Samuel notices Yvette	sem	notice ( samuel , yvettte )
Samuel notices Zelda	sem	notice ( samuel , zelda )
Samuel knows Claire	sem	know ( samuel , claire )
Samuel knows Daniel	sem	know ( samuel , daniel )
Samuel knows Grace	sem	know ( samuel , grace )
Samuel knows Henry	sem	know ( samuel , henry )
Samuel knows Isla	sem	know ( samuel , isla )
Samuel knows John	sem	know ( samuel , john )
Samuel knows Katherine	sem	know ( samuel , katherine )
Samuel knows Lewis	sem	know ( samuel , lewis )
Samuel knows Margaret	sem	know ( samuel , margaret )
Samuel knows Neha	sem	know ( samuel , neha )
Samuel knows Oswald	sem	know ( samuel , oswald )
Samuel knows Patricia	sem	know ( samuel , patricia )
Samuel knows Quinn	sem	know ( samuel , quinn )
Samuel knows Samuel	sem	know ( samuel , samuel )
Samuel knows Tracy	sem	know ( samuel , tracy )
Samuel knows Victor	sem	know ( samuel , victor )
Samuel knows Winnifred	sem	know ( samuel , winnifred )
Samuel knows Xerxes	sem	know ( samuel , xerxes )
Samuel knows Yvette	sem	know ( samuel , yvettte )
Samuel knows Zelda	sem	know ( samuel , zelda )
Samuel meets himself	sem	meet ( samuel , samuel )
Samuel likes himself	sem	like ( samuel , samuel )
Samuel notices himself	sem	notice ( samuel , samuel )
Samuel knows himself	sem	know ( samuel , samuel )
Tracy walks	sem	walk ( tracy )
Tracy sleeps	sem	sleep ( tracy )
Tracy runs	sem	run ( tracy )
Tracy sings	sem	sing ( tracy )
Tracy dances	sem	dance ( tracy )
Tracy slumbers	sem	slumber ( tracy )
Tracy sees Bob	sem	see ( tracy , bob )
Tracy sees Claire	sem	see ( tracy , claire )
Tracy sees Daniel	sem	see ( tracy , daniel )
Tracy sees Francis	sem	see ( tracy , francis )
Tracy sees Grace	sem	see ( tracy , grace )
Tracy sees Henry	sem	see ( tracy , henry )
Tracy sees Isla	sem	see ( tracy , isla )
Tracy sees John	sem	see ( tracy , john )
Tracy sees Katherine	sem	see ( tracy , katherine )
Tracy sees Neha	sem	see ( tracy , neha )
Tracy sees Patricia	sem	see ( tracy , patricia )
Tracy sees Quinn	sem	see ( tracy , quinn )
Tracy sees Rachael	sem	see ( tracy , rachael )
Tracy sees Tracy	sem	see ( tracy , tracy )
Tracy sees Ursula	sem	see ( tracy , ursula )
Tracy sees Victor	sem	see ( tracy , victor )
Tracy sees Xerxes	sem	see ( tracy , xerxes )
Tracy sees Yvette	sem	see ( tracy , yvettte )
Tracy sees Zelda	sem	see ( tracy , zelda )
Tracy meets Claire	sem	meet ( tracy , claire )
Tracy meets Daniel	sem	meet ( tracy , daniel )
Tracy meets Eliza	sem	meet ( tracy , eliza )
Tracy meets Francis	sem	meet ( tracy , francis )
Tracy meets Grace	sem	meet ( tracy , grace )
Tracy meets Henry	sem	meet ( tracy , henry )
Tracy meets John	sem	meet ( tracy , john )
Tracy meets Katherine	sem	meet ( tracy , katherine )
Tracy meets Lewis	sem	meet ( tracy , lewis )
Tracy meets Margaret	sem	meet ( tracy , margaret )
Tracy meets Patricia	sem	meet ( tracy , patricia )
Tracy meets Quinn	sem	meet ( tracy , quinn )
Tracy meets Rachael	sem	meet ( tracy , rachael )
Tracy meets Samuel	sem	meet ( tracy , samuel )
Tracy meets Ursula	sem	meet ( tracy , ursula )
Tracy meets Winnifred	sem	meet ( tracy , winnifred )
Tracy meets Xerxes	sem	meet ( tracy , xerxes )
Tracy meets Yvette	sem	meet ( tracy , yvettte )
Tracy meets Zelda	sem	meet ( tracy , zelda )
Tracy likes Bob	sem	like ( tracy , bob )
Tracy likes Claire	sem	like ( tracy , claire )
Tracy likes Daniel	sem	like ( tracy , daniel )
Tracy likes Eliza	sem	like ( tracy , eliza )
Tracy likes Francis	sem	like ( tracy , francis )
Tracy likes Grace	sem	like ( tracy , grace )
Tracy likes Henry	sem	like ( tracy , henry )
Tracy likes Isla	sem	like ( tracy , isla )
Tracy likes John	sem	like ( tracy , john )
Tracy likes Katherine	sem	like ( tracy , katherine )
Tracy likes Lewis	sem	like ( tracy , lewis )
Tracy likes Margaret	sem	like ( tracy , margaret )
Tracy likes Neha	sem	like ( tracy , neha )
Tracy likes Oswald	sem	like ( tracy , oswald )
Tracy likes Patricia	sem	like ( tracy , patricia )
Tracy likes Rachael	sem	like ( tracy , rachael )
Tracy likes Samuel	sem	like ( tracy , samuel )
Tracy likes Tracy	sem	like ( tracy , tracy )
Tracy likes Ursula	sem	like ( tracy , ursula )
Tracy likes Victor	sem	like ( tracy , victor )
Tracy likes Winnifred	sem	like ( tracy , winnifred )
Tracy likes Xerxes	sem	like ( tracy , xerxes )
Tracy likes Yvette	sem	like ( tracy , yvettte )
Tracy likes Zelda	sem	like ( tracy , zelda )
Tracy dislikes Bob	sem	dislike ( tracy , bob )
Tracy dislikes Francis	sem	dislike ( tracy , francis )
Tracy dislikes Henry	sem	dislike ( tracy , henry )
Tracy dislikes Isla	sem	dislike ( tracy , isla )
Tracy dislikes John	sem	dislike ( tracy , john )
Tracy dislikes Katherine	sem	dislike ( tracy , katherine )
Tracy dislikes Lewis	sem	dislike ( tracy , lewis )
Tracy dislikes Margaret	sem	dislike ( tracy , margaret )
Tracy dislikes Neha	sem	dislike ( tracy , neha )
Tracy dislikes Oswald	sem	dislike ( tracy , oswald )
Tracy dislikes Patricia	sem	dislike ( tracy , patricia )
Tracy dislikes Quinn	sem	dislike ( tracy , quinn )
Tracy dislikes Rachael	sem	dislike ( tracy , rachael )
Tracy dislikes Samuel	sem	dislike ( tracy , samuel )
Tracy dislikes Ursula	sem	dislike ( tracy , ursula )
Tracy dislikes Victor	sem	dislike ( tracy , victor )
Tracy dislikes Winnifred	sem	dislike ( tracy , winnifred )
Tracy dislikes Yvette	sem	dislike ( tracy , yvettte )
Tracy throws Bob	sem	throw ( tracy , bob )
Tracy throws Claire	sem	throw ( tracy , claire )
Tracy throws Daniel	sem	throw ( tracy , daniel )
Tracy throws Eliza	sem	throw ( tracy , eliza )
Tracy throws Francis	sem	throw ( tracy , francis )
Tracy throws Grace	sem	throw ( tracy , grace )
Tracy throws Henry	sem	throw ( tracy , henry )
Tracy throws Isla	sem	throw ( tracy , isla )
Tracy throws Katherine	sem	throw ( tracy , katherine )
Tracy throws Lewis	sem	throw ( tracy , lewis )
Tracy throws Margaret	sem	throw ( tracy , margaret )
Tracy throws Patricia	sem	throw ( tracy , patricia )
Tracy throws Quinn	sem	throw ( tracy , quinn )
Tracy throws Rachael	sem	throw ( tracy , rachael )
Tracy throws Samuel	sem	throw ( tracy , samuel )
Tracy throws Tracy	sem	throw ( tracy , tracy )
Tracy throws Ursula	sem	throw ( tracy , ursula )
Tracy throws Victor	sem	throw ( tracy , victor )
Tracy throws Winnifred	sem	throw ( tracy , winnifred )
Tracy throws Xerxes	sem	throw ( tracy , xerxes )
Tracy throws Yvette	sem	throw ( tracy , yvettte )
Tracy throws Zelda	sem	throw ( tracy , zelda )
Tracy notices Daniel	sem	notice ( tracy , daniel )
Tracy notices Eliza	sem	notice ( tracy , eliza )
Tracy notices Francis	sem	notice ( tracy , francis )
Tracy notices Grace	sem	notice ( tracy , grace )
Tracy notices Henry	sem	notice ( tracy , henry )
Tracy notices Isla	sem	notice ( tracy , isla )
Tracy notices John	sem	notice ( tracy , john )
Tracy notices Katherine	sem	notice ( tracy , katherine )
Tracy notices Lewis	sem	notice ( tracy , lewis )
Tracy notices Margaret	sem	notice ( tracy , margaret )
Tracy notices Neha	sem	notice ( tracy , neha )
Tracy notices Oswald	sem	notice ( tracy , oswald )
Tracy notices Patricia	sem	notice ( tracy , patricia )
Tracy notices Quinn	sem	notice ( tracy , quinn )
Tracy notices Rachael	sem	notice ( tracy , rachael )
Tracy notices Samuel	sem	notice ( tracy , samuel )
Tracy notices Ursula	sem	notice ( tracy , ursula )
Tracy notices Victor	sem	notice ( tracy , victor )
Tracy notices Winnifred	sem	notice ( tracy , winnifred )
Tracy notices Xerxes	sem	notice ( tracy , xerxes )
Tracy notices Yvette	sem	notice ( tracy , yvettte )
Tracy notices Zelda	sem	notice ( tracy , zelda )
Tracy knows Claire	sem	know ( tracy , claire )
Tracy knows Daniel	sem	know ( tracy , daniel )
Tracy knows Eliza	sem	know ( tracy , eliza )
Tracy knows Grace	sem	know ( tracy , grace )
Tracy knows Henry	sem	know ( tracy , henry )
Tracy knows Isla	sem	know ( tracy , isla )
Tracy knows John	sem	know ( tracy , john )
Tracy knows Katherine	sem	know ( tracy , katherine )
Tracy knows Lewis	sem	know ( tracy , lewis )
Tracy knows Margaret	sem	know ( tracy , margaret )
Tracy knows Neha	sem	know ( tracy , neha )
Tracy knows Patricia	sem	know ( tracy , patricia )
Tracy knows Quinn	sem	know ( tracy , quinn )
Tracy knows Rachael	sem	know ( tracy , rachael )
Tracy knows Samuel	sem	know ( tracy , samuel )
Tracy knows Tracy	sem	know ( tracy , tracy )
Tracy knows Ursula	sem	know ( tracy , ursula )
Tracy knows Winnifred	sem	know ( tracy , winnifred )
Tracy knows Xerxes	sem	know ( tracy , xerxes )
Tracy knows Zelda	sem	know ( tracy , zelda )
Tracy sees herself	sem	see ( tracy , tracy )
Tracy meets herself	sem	meet ( tracy , tracy )
Tracy likes herself	sem	like ( tracy , tracy )
Tracy dislikes herself	sem	dislike ( tracy , tracy )
Tracy throws herself	sem	throw ( tracy , tracy )
Tracy notices herself	sem	notice ( tracy , tracy )
Tracy knows herself	sem	know ( tracy , tracy )
Ursula walks	sem	walk ( ursula )
Ursula sleeps	sem	sleep ( ursula )
Ursula eats	sem	eat ( ursula )
Ursula runs	sem	run ( ursula )
Ursula sings	sem	sing ( ursula )
Ursula flies	sem	fly ( ursula )
Ursula slumbers	sem	slumber ( ursula )
Ursula sees Bob	sem	see ( ursula , bob )
Ursula sees Claire	sem	see ( ursula , claire )
Ursula sees Daniel	sem	see ( ursula , daniel )
Ursula sees Eliza	sem	see ( ursula , eliza )
Ursula sees Francis	sem	see ( ursula , francis )
Ursula sees Grace	sem	see ( ursula , grace )
Ursula sees Henry	sem	see ( ursula , henry )
Ursula sees Isla	sem	see ( ursula , isla )
Ursula sees Katherine	sem	see ( ursula , katherine )
Ursula sees Lewis	sem	see ( ursula , lewis )
Ursula sees Margaret	sem	see ( ursula , margaret )
Ursula sees Neha	sem	see ( ursula , neha )
Ursula sees Oswald	sem	see ( ursula , oswald )
Ursula sees Patricia	sem	see ( ursula , patricia )
Ursula sees Quinn	sem	see ( ursula , quinn )
Ursula sees Rachael	sem	see ( ursula , rachael )
Ursula sees Samuel	sem	see ( ursula , samuel )
Ursula sees Tracy	sem	see ( ursula , tracy )
Ursula sees Ursula	sem	see ( ursula , ursula )
Ursula sees Winnifred	sem	see ( ursula , winnifred )
Ursula sees Yvette	sem	see ( ursula , yvettte )
Ursula sees Zelda	sem	see ( ursula , zelda )
Ursula meets Bob	sem	meet ( ursula , bob )
Ursula meets Daniel	sem	meet ( ursula , daniel )
Ursula meets Eliza	sem	meet ( ursula , eliza )
Ursula meets Francis	sem	meet ( ursula , francis )
Ursula meets Henry	sem	meet ( ursula , henry )
Ursula meets Katherine	sem	meet ( ursula , katherine )
Ursula meets Lewis	sem	meet ( ursula , lewis )
Ursula meets Margaret	sem	meet ( ursula , margaret )
Ursula meets Neha	sem	meet ( ursula , neha )
Ursula meets Oswald	sem	meet ( ursula , oswald )
Ursula meets Quinn	sem	meet ( ursula , quinn )
Ursula meets Rachael	sem	meet ( ursula , rachael )
Ursula meets Samuel	sem	meet ( ursula , samuel )
Ursula meets Tracy	sem	meet ( ursula , tracy )
Ursula meets Winnifred	sem	meet ( ursula , winnifred )
Ursula meets Xerxes	sem	meet ( ursula , xerxes )
Ursula meets Yvette	sem	meet ( ursula , yvettte )
Ursula likes Daniel	sem	like ( ursula , daniel )
Ursula likes Eliza	sem	like ( ursula , eliza )
Ursula likes Francis	sem	like ( ursula , francis )
Ursula likes Henry	sem	like ( ursula , henry )
Ursula likes Isla	sem	like ( ursula , isla )
Ursula likes John	sem	like ( ursula , john )
Ursula likes Katherine	sem	like ( ursula , katherine )
Ursula likes Neha	sem	like ( ursula , neha )
Ursula likes Patricia	sem	like ( ursula , patricia )
Ursula likes Rachael	sem	like ( ursula , rachael )
Ursula likes Samuel	sem	like ( ursula , samuel )
Ursula likes Ursula	sem	like ( ursula , ursula )
Ursula likes Victor	sem	like ( ursula , victor )
Ursula likes Winnifred	sem	like ( ursula , winnifred )
Ursula likes Xerxes	sem	like ( ursula , xerxes )
Ursula likes Yvette	sem	like ( ursula , yvettte )
Ursula likes Zelda	sem	like ( ursula , zelda )
Ursula dislikes Bob	sem	dislike ( ursula , bob )
Ursula dislikes Claire	sem	dislike ( ursula , claire )
Ursula dislikes Eliza	sem	dislike ( ursula , eliza )
Ursula dislikes Francis	sem	dislike ( ursula , francis )
Ursula dislikes Grace	sem	dislike ( ursula , grace )
Ursula dislikes Henry	sem	dislike ( ursula , henry )
Ursula dislikes Isla	sem	dislike ( ursula , isla )
Ursula dislikes John	sem	dislike ( ursula , john )
Ursula dislikes Katherine	sem	dislike ( ursula , katherine )
Ursula dislikes Lewis	sem	dislike ( ursula , lewis )
Ursula dislikes Margaret	sem	dislike ( ursula , margaret )
Ursula dislikes Neha	sem	dislike ( ursula , neha )
Ursula dislikes Patricia	sem	dislike ( ursula , patricia )
Ursula dislikes Quinn	sem	dislike ( ursula , quinn )
Ursula dislikes Rachael	sem	dislike ( ursula , rachael )
Ursula dislikes Samuel	sem	dislike ( ursula , samuel )
Ursula dislikes Victor	sem	dislike ( ursula , victor )
Ursula dislikes Winnifred	sem	dislike ( ursula , winnifred )
Ursula dislikes Xerxes	sem	dislike ( ursula , xerxes )
Ursula dislikes Yvette	sem	dislike ( ursula , yvettte )
Ursula dislikes Zelda	sem	dislike ( ursula , zelda )
Ursula throws Bob	sem	throw ( ursula , bob )
Ursula throws Claire	sem	throw ( ursula , claire )
Ursula throws Daniel	sem	throw ( ursula , daniel )
Ursula throws Eliza	sem	throw ( ursula , eliza )
Ursula throws Grace	sem	throw ( ursula , grace )
Ursula throws John	sem	throw ( ursula , john )
Ursula throws Katherine	sem	throw ( ursula , katherine )
Ursula throws Lewis	sem	throw ( ursula , lewis )
Ursula throws Margaret	sem	throw ( ursula , margaret )
Ursula throws Neha	sem	throw ( ursula , neha )
Ursula throws Oswald	sem	throw ( ursula , oswald )
Ursula throws Patricia	sem	throw ( ursula , patricia )
Ursula throws Quinn	sem	throw ( ursula , quinn )
Ursula throws Rachael	sem	throw ( ursula , rachael )
Ursula throws Tracy	sem	throw ( ursula , tracy )
Ursula throws Winnifred	sem	throw ( ursula , winnifred )
Ursula throws Xerxes	sem	throw ( ursula , xerxes )
Ursula throws Yvette	sem	throw ( ursula , yvettte )
Ursula throws Zelda	sem	throw ( ursula , zelda )
Ursula notices Bob	sem	notice ( ursula , bob )
Ursula notices Claire	sem	notice ( ursula , claire )
Ursula notices Daniel	sem	notice ( ursula , daniel )
Ursula notices Francis	sem	notice ( ursula , francis )
Ursula notices Grace	sem	notice ( ursula , grace )
Ursula notices John	sem	notice ( ursula , john )
Ursula notices Katherine	sem	notice ( ursula , katherine )
Ursula notices Lewis	sem	notice ( ursula , lewis )
Ursula notices Margaret	sem	notice ( ursula , margaret )
Ursula notices Neha	sem	notice ( ursula , neha )
Ursula notices Oswald	sem	notice ( ursula , oswald )
Ursula notices Patricia	sem	notice ( ursula , patricia )
Ursula notices Quinn	sem	notice ( ursula , quinn )
Ursula notices Tracy	sem	notice ( ursula , tracy )
Ursula notices Ursula	sem	notice ( ursula , ursula )
Ursula notices Victor	sem	notice ( ursula , victor )
Ursula notices Winnifred	sem	notice ( ursula , winnifred )
Ursula notices Xerxes	sem	notice ( ursula , xerxes )
Ursula notices Yvette	sem	notice ( ursula , yvettte )
Ursula notices Zelda	sem	notice ( ursula , zelda )
Ursula knows Bob	sem	know ( ursula , bob )
Ursula knows Daniel	sem	know ( ursula , daniel )
Ursula knows Francis	sem	know ( ursula , francis )
Ursula knows Grace	sem	know ( ursula , grace )
Ursula knows Henry	sem	know ( ursula , henry )
Ursula knows Isla	sem	know ( ursula , isla )
Ursula knows John	sem	know ( ursula , john )
Ursula knows Katherine	sem	know ( ursula , katherine )
Ursula knows Lewis	sem	know ( ursula , lewis )
Ursula knows Margaret	sem	know ( ursula , margaret )
Ursula knows Neha	sem	know ( ursula , neha )
Ursula knows Patricia	sem	know ( ursula , patricia )
Ursula knows Quinn	sem	know ( ursula , quinn )
Ursula knows Samuel	sem	know ( ursula , samuel )
Ursula knows Ursula	sem	know ( ursula , ursula )
Ursula knows Victor	sem	know ( ursula , victor )
Ursula knows Winnifred	sem	know ( ursula , winnifred )
Ursula knows Xerxes	sem	know ( ursula , xerxes )
Ursula knows Yvette	sem	know ( ursula , yvettte )
Ursula knows Zelda	sem	know ( ursula , zelda )
Ursula sees herself	sem	see ( ursula , ursula )
Ursula likes herself	sem	like ( ursula , ursula )
Ursula dislikes herself	sem	dislike ( ursula , ursula )
Ursula throws herself	sem	throw ( ursula , ursula )
Ursula notices herself	sem	notice ( ursula , ursula )
Victor walks	sem	walk ( victor )
Victor eats	sem	eat ( victor )
Victor runs	sem	run ( victor )
Victor sings	sem	sing ( victor )
Victor dances	sem	dance ( victor )
Victor slumbers	sem	slumber ( victor )
Victor sees Bob	sem	see ( victor , bob )
Victor sees Claire	sem	see ( victor , claire )
Victor sees Daniel	sem	see ( victor , daniel )
Victor sees Eliza	sem	see ( victor , eliza )
Victor sees Francis	sem	see ( victor , francis )
Victor sees Grace	sem	see ( victor , grace )
Victor sees Henry	sem	see ( victor , henry )
Victor sees Isla	sem	see ( victor , isla )
Victor sees John	sem	see ( victor , john )
Victor sees Katherine	sem	see ( victor , katherine )
Victor sees Lewis	sem	see ( victor , lewis )
Victor sees Neha	sem	see ( victor , neha )
Victor sees Oswald	sem	see ( victor , oswald )
Victor sees Patricia	sem	see ( victor , patricia )
Victor sees Quinn	sem	see ( victor , quinn )
Victor sees Rachael	sem	see ( victor , rachael )
Victor sees Tracy	sem	see ( victor , tracy )
Victor sees Ursula	sem	see ( victor , ursula )
Victor sees Yvette	sem	see ( victor , yvettte )
Victor sees Zelda	sem	see ( victor , zelda )
Victor meets Claire	sem	meet ( victor , claire )
Victor meets Eliza	sem	meet ( victor , eliza )
Victor meets Francis	sem	meet ( victor , francis )
Victor meets Henry	sem	meet ( victor , henry )
Victor meets John	sem	meet ( victor , john )
Victor meets Katherine	sem	meet ( victor , katherine )
Victor meets Lewis	sem	meet ( victor , lewis )
Victor meets Margaret	sem	meet ( victor , margaret )
Victor meets Neha	sem	meet ( victor , neha )
Victor meets Quinn	sem	meet ( victor , quinn )
Victor meets Rachael	sem	meet ( victor , rachael )
Victor meets Samuel	sem	meet ( victor , samuel )
Victor meets Ursula	sem	meet ( victor , ursula )
Victor meets Victor	sem	meet ( victor , victor )
Victor meets Xerxes	sem	meet ( victor , xerxes )
Victor meets Yvette	sem	meet ( victor , yvettte )
Victor likes Bob	sem	like ( victor , bob )
Victor likes Claire	sem	like ( victor , claire )
Victor likes Daniel	sem	like ( victor , daniel )
Victor likes Eliza	sem	like ( victor , eliza )
Victor likes Francis	sem	like ( victor , francis )
Victor likes Henry	sem	like ( victor , henry )
Victor likes Isla	sem	like ( victor , isla )
Victor likes John	sem	like ( victor , john )
Victor likes Katherine	sem	like ( victor , katherine )
Victor likes Lewis	sem	like ( victor , lewis )
Victor likes Margaret	sem	like ( victor , margaret )
Victor likes Neha	sem	like ( victor , neha )
Victor likes Oswald	sem	like ( victor , oswald )
Victor likes Quinn	sem	like ( victor , quinn )
Victor likes Rachael	sem	like ( victor , rachael )
Victor likes Samuel	sem	like ( victor , samuel )
Victor likes Ursula	sem	like ( victor , ursula )
Victor likes Victor	sem	like ( victor , victor )
Victor likes Winnifred	sem	like ( victor , winnifred )
Victor likes Xerxes	sem	like ( victor , xerxes )
Victor likes Yvette	sem	like ( victor , yvettte )
Victor likes Zelda	sem	like ( victor , zelda )
Victor dislikes Bob	sem	dislike ( victor , bob )
Victor dislikes Claire	sem	dislike ( victor , claire )
Victor dislikes Daniel	sem	dislike ( victor , daniel )
Victor dislikes Eliza	sem	dislike ( victor , eliza )
Victor dislikes Francis	sem	dislike ( victor , francis )
Victor dislikes Grace	sem	dislike ( victor , grace )
Victor dislikes Henry	sem	dislike ( victor , henry )
Victor dislikes Isla	sem	dislike ( victor , isla )
Victor dislikes John	sem	dislike ( victor , john )
Victor dislikes Katherine	sem	dislike ( victor , katherine )
Victor dislikes Lewis	sem	dislike ( victor , lewis )
Victor dislikes Margaret	sem	dislike ( victor , margaret )
Victor dislikes Oswald	sem	dislike ( victor , oswald )
Victor dislikes Patricia	sem	dislike ( victor , patricia )
Victor dislikes Quinn	sem	dislike ( victor , quinn )
Victor dislikes Rachael	sem	dislike ( victor , rachael )
Victor dislikes Samuel	sem	dislike ( victor , samuel )
Victor dislikes Ursula	sem	dislike ( victor , ursula )
Victor dislikes Victor	sem	dislike ( victor , victor )
Victor dislikes Winnifred	sem	dislike ( victor , winnifred )
Victor dislikes Xerxes	sem	dislike ( victor , xerxes )
Victor dislikes Zelda	sem	dislike ( victor , zelda )
Victor throws Bob	sem	throw ( victor , bob )
Victor throws Claire	sem	throw ( victor , claire )
Victor throws Daniel	sem	throw ( victor , daniel )
Victor throws Eliza	sem	throw ( victor , eliza )
Victor throws Francis	sem	throw ( victor , francis )
Victor throws Grace	sem	throw ( victor , grace )
Victor throws Henry	sem	throw ( victor , henry )
Victor throws Isla	sem	throw ( victor , isla )
Victor throws John	sem	throw ( victor , john )
Victor throws Katherine	sem	throw ( victor , katherine )
Victor throws Lewis	sem	throw ( victor , lewis )
Victor throws Oswald	sem	throw ( victor , oswald )
Victor throws Quinn	sem	throw ( victor , quinn )
Victor throws Rachael	sem	throw ( victor , rachael )
Victor throws Samuel	sem	throw ( victor , samuel )
Victor throws Tracy	sem	throw ( victor , tracy )
Victor throws Victor	sem	throw ( victor , victor )
Victor throws Winnifred	sem	throw ( victor , winnifred )
Victor throws Yvette	sem	throw ( victor , yvettte )
Victor throws Zelda	sem	throw ( victor , zelda )
Victor notices Bob	sem	notice ( victor , bob )
Victor notices Claire	sem	notice ( victor , claire )
Victor notices Daniel	sem	notice ( victor , daniel )
Victor notices Francis	sem	notice ( victor , francis )
Victor notices Grace	sem	notice ( victor , grace )
Victor notices Henry	sem	notice ( victor , henry )
Victor notices Isla	sem	notice ( victor , isla )
Victor notices Katherine	sem	notice ( victor , katherine )
Victor notices Neha	sem	notice ( victor , neha )
Victor notices Quinn	sem	notice ( victor , quinn )
Victor notices Rachael	sem	notice ( victor , rachael )
Victor notices Winnifred	sem	notice ( victor , winnifred )
Victor notices Yvette	sem	notice ( victor , yvettte )
Victor notices Zelda	sem	notice ( victor , zelda )
Victor knows Bob	sem	know ( victor , bob )
Victor knows Claire	sem	know ( victor , claire )
Victor knows Daniel	sem	know ( victor , daniel )
Victor knows Eliza	sem	know ( victor , eliza )
Victor knows Francis	sem	know ( victor , francis )
Victor knows Grace	sem	know ( victor , grace )
Victor knows Henry	sem	know ( victor , henry )
Victor knows Isla	sem	know ( victor , isla )
Victor knows John	sem	know ( victor , john )
Victor knows Katherine	sem	know ( victor , katherine )
Victor knows Lewis	sem	know ( victor , lewis )
Victor knows Margaret	sem	know ( victor , margaret )
Victor knows Neha	sem	know ( victor , neha )
Victor knows Oswald	sem	know ( victor , oswald )
Victor knows Patricia	sem	know ( victor , patricia )
Victor knows Quinn	sem	know ( victor , quinn )
Victor knows Samuel	sem	know ( victor , samuel )
Victor knows Tracy	sem	know ( victor , tracy )
Victor knows Ursula	sem	know ( victor , ursula )
Victor knows Winnifred	sem	know ( victor , winnifred )
Victor knows Xerxes	sem	know ( victor , xerxes )
Victor knows Yvette	sem	know ( victor , yvettte )
Victor knows Zelda	sem	know ( victor , zelda )
Victor throws himself	sem	throw ( victor , victor )
Victor notices himself	sem	notice ( victor , victor )
Victor knows himself	sem	know ( victor , victor )
Winnifred walks	sem	walk ( winnifred )
Winnifred eats	sem	eat ( winnifred )
Winnifred runs	sem	run ( winnifred )
Winnifred sings	sem	sing ( winnifred )
Winnifred flies	sem	fly ( winnifred )
Winnifred slumbers	sem	slumber ( winnifred )
Winnifred sees Bob	sem	see ( winnifred , bob )
Winnifred sees Claire	sem	see ( winnifred , claire )
Winnifred sees Daniel	sem	see ( winnifred , daniel )
Winnifred sees Eliza	sem	see ( winnifred , eliza )
Winnifred sees Francis	sem	see ( winnifred , francis )
Winnifred sees Henry	sem	see ( winnifred , henry )
Winnifred sees John	sem	see ( winnifred , john )
Winnifred sees Katherine	sem	see ( winnifred , katherine )
Winnifred sees Lewis	sem	see ( winnifred , lewis )
Winnifred sees Margaret	sem	see ( winnifred , margaret )
Winnifred sees Neha	sem	see ( winnifred , neha )
Winnifred sees Oswald	sem	see ( winnifred , oswald )
Winnifred sees Patricia	sem	see ( winnifred , patricia )
Winnifred sees Quinn	sem	see ( winnifred , quinn )
Winnifred sees Rachael	sem	see ( winnifred , rachael )
Winnifred sees Samuel	sem	see ( winnifred , samuel )
Winnifred sees Tracy	sem	see ( winnifred , tracy )
Winnifred sees Winnifred	sem	see ( winnifred , winnifred )
Winnifred sees Xerxes	sem	see ( winnifred , xerxes )
Winnifred sees Yvette	sem	see ( winnifred , yvettte )
Winnifred sees Zelda	sem	see ( winnifred , zelda )
Winnifred meets Bob	sem	meet ( winnifred , bob )
Winnifred meets Claire	sem	meet ( winnifred , claire )
Winnifred meets Daniel	sem	meet ( winnifred , daniel )
Winnifred meets Eliza	sem	meet ( winnifred , eliza )
Winnifred meets Francis	sem	meet ( winnifred , francis )
Winnifred meets Grace	sem	meet ( winnifred , grace )
Winnifred meets Henry	sem	meet ( winnifred , henry )
Winnifred meets Isla	sem	meet ( winnifred , isla )
Winnifred meets John	sem	meet ( winnifred , john )
Winnifred meets Katherine	sem	meet ( winnifred , katherine )
Winnifred meets Lewis	sem	meet ( winnifred , lewis )
Winnifred meets Margaret	sem	meet ( winnifred , margaret )
Winnifred meets Neha	sem	meet ( winnifred , neha )
Winnifred meets Oswald	sem	meet ( winnifred , oswald )
Winnifred meets Patricia	sem	meet ( winnifred , patricia )
Winnifred meets Quinn	sem	meet ( winnifred , quinn )
Winnifred meets Rachael	sem	meet ( winnifred , rachael )
Winnifred meets Samuel	sem	meet ( winnifred , samuel )
Winnifred meets Tracy	sem	meet ( winnifred , tracy )
Winnifred meets Ursula	sem	meet ( winnifred , ursula )
Winnifred meets Winnifred	sem	meet ( winnifred , winnifred )
Winnifred meets Xerxes	sem	meet ( winnifred , xerxes )
Winnifred meets Yvette	sem	meet ( winnifred , yvettte )
Winnifred meets Zelda	sem	meet ( winnifred , zelda )
Winnifred likes Bob	sem	like ( winnifred , bob )
Winnifred likes Claire	sem	like ( winnifred , claire )
Winnifred likes Daniel	sem	like ( winnifred , daniel )
Winnifred likes Eliza	sem	like ( winnifred , eliza )
Winnifred likes Grace	sem	like ( winnifred , grace )
Winnifred likes Henry	sem	like ( winnifred , henry )
Winnifred likes Isla	sem	like ( winnifred , isla )
Winnifred likes John	sem	like ( winnifred , john )
Winnifred likes Margaret	sem	like ( winnifred , margaret )
Winnifred likes Neha	sem	like ( winnifred , neha )
Winnifred likes Oswald	sem	like ( winnifred , oswald )
Winnifred likes Quinn	sem	like ( winnifred , quinn )
Winnifred likes Rachael	sem	like ( winnifred , rachael )
Winnifred likes Samuel	sem	like ( winnifred , samuel )
Winnifred likes Tracy	sem	like ( winnifred , tracy )
Winnifred likes Ursula	sem	like ( winnifred , ursula )
Winnifred likes Victor	sem	like ( winnifred , victor )
Winnifred likes Winnifred	sem	like ( winnifred , winnifred )
Winnifred likes Yvette	sem	like ( winnifred , yvettte )
Winnifred likes Zelda	sem	like ( winnifred , zelda )
Winnifred dislikes Bob	sem	dislike ( winnifred , bob )
Winnifred dislikes Claire	sem	dislike ( winnifred , claire )
Winnifred dislikes Eliza	sem	dislike ( winnifred , eliza )
Winnifred dislikes Francis	sem	dislike ( winnifred , francis )
Winnifred dislikes Grace	sem	dislike ( winnifred , grace )
Winnifred dislikes Henry	sem	dislike ( winnifred , henry )
Winnifred dislikes Isla	sem	dislike ( winnifred , isla )
Winnifred dislikes John	sem	dislike ( winnifred , john )
Winnifred dislikes Lewis	sem	dislike ( winnifred , lewis )
Winnifred dislikes Margaret	sem	dislike ( winnifred , margaret )
Winnifred dislikes Neha	sem	dislike ( winnifred , neha )
Winnifred dislikes Oswald	sem	dislike ( winnifred , oswald )
Winnifred dislikes Patricia	sem	dislike ( winnifred , patricia )
Winnifred dislikes Rachael	sem	dislike ( winnifred , rachael )
Winnifred dislikes Samuel	sem	dislike ( winnifred , samuel )
Winnifred dislikes Ursula	sem	dislike ( winnifred , ursula )
Winnifred dislikes Victor	sem	dislike ( winnifred , victor )
Winnifred dislikes Winnifred	sem	dislike ( winnifred , winnifred )
Winnifred dislikes Xerxes	sem	dislike ( winnifred , xerxes )
Winnifred dislikes Yvette	sem	dislike ( winnifred , yvettte )
Winnifred dislikes Zelda	sem	dislike ( winnifred , zelda )
Winnifred throws Bob	sem	throw ( winnifred , bob )
Winnifred throws Claire	sem	throw ( winnifred , claire )
Winnifred throws Eliza	sem	throw ( winnifred , eliza )
Winnifred throws Francis	sem	throw ( winnifred , francis )
Winnifred throws Grace	sem	throw ( winnifred , grace )
Winnifred throws Isla	sem	throw ( winnifred , isla )
Winnifred throws John	sem	throw ( winnifred , john )
Winnifred throws Katherine	sem	throw ( winnifred , katherine )
Winnifred throws Lewis	sem	throw ( winnifred , lewis )
Winnifred throws Margaret	sem	throw ( winnifred , margaret )
Winnifred throws Neha	sem	throw ( winnifred , neha )
Winnifred throws Patricia	sem	throw ( winnifred , patricia )
Winnifred throws Quinn	sem	throw ( winnifred , quinn )
Winnifred throws Rachael	sem	throw ( winnifred , rachael )
Winnifred throws Samuel	sem	throw ( winnifred , samuel )
Winnifred throws Tracy	sem	throw ( winnifred , tracy )
Winnifred throws Ursula	sem	throw ( winnifred , ursula )
Winnifred throws Winnifred	sem	throw ( winnifred , winnifred )
Winnifred throws Xerxes	sem	throw ( winnifred , xerxes )
Winnifred throws Yvette	sem	throw ( winnifred , yvettte )
Winnifred throws Zelda	sem	throw ( winnifred , zelda )
Winnifred notices Bob	sem	notice ( winnifred , bob )
Winnifred notices Claire	sem	notice ( winnifred , claire )
Winnifred notices Eliza	sem	notice ( winnifred , eliza )
Winnifred notices Francis	sem	notice ( winnifred , francis )
Winnifred notices Grace	sem	notice ( winnifred , grace )
Winnifred notices Henry	sem	notice ( winnifred , henry )
Winnifred notices Isla	sem	notice ( winnifred , isla )
Winnifred notices John	sem	notice ( winnifred , john )
Winnifred notices Katherine	sem	notice ( winnifred , katherine )
Winnifred notices Lewis	sem	notice ( winnifred , lewis )
Winnifred notices Oswald	sem	notice ( winnifred , oswald )
Winnifred notices Rachael	sem	notice ( winnifred , rachael )
Winnifred notices Samuel	sem	notice ( winnifred , samuel )
Winnifred notices Tracy	sem	notice ( winnifred , tracy )
Winnifred notices Ursula	sem	notice ( winnifred , ursula )
Winnifred notices Victor	sem	notice ( winnifred , victor )
Winnifred notices Winnifred	sem	notice ( winnifred , winnifred )
Winnifred notices Xerxes	sem	notice ( winnifred , xerxes )
Winnifred notices Yvette	sem	notice ( winnifred , yvettte )
Winnifred notices Zelda	sem	notice ( winnifred , zelda )
Winnifred knows Bob	sem	know ( winnifred , bob )
Winnifred knows Claire	sem	know ( winnifred , claire )
Winnifred knows Daniel	sem	know ( winnifred , daniel )
Winnifred knows Eliza	sem	know ( winnifred , eliza )
Winnifred knows Grace	sem	know ( winnifred , grace )
Winnifred knows Henry	sem	know ( winnifred , henry )
Winnifred knows Isla	sem	know ( winnifred , isla )
Winnifred knows John	sem	know ( winnifred , john )
Winnifred knows Katherine	sem	know ( winnifred , katherine )
Winnifred knows Lewis	sem	know ( winnifred , lewis )
Winnifred knows Margaret	sem	know ( winnifred , margaret )
Winnifred knows Neha	sem	know ( winnifred , neha )
Winnifred knows Oswald	sem	know ( winnifred , oswald )
Winnifred knows Patricia	sem	know ( winnifred , patricia )
Winnifred knows Quinn	sem	know ( winnifred , quinn )
Winnifred knows Rachael	sem	know ( winnifred , rachael )
Winnifred knows Samuel	sem	know ( winnifred , samuel )
Winnifred knows Tracy	sem	know ( winnifred , tracy )
Winnifred knows Ursula	sem	know ( winnifred , ursula )
Winnifred knows Victor	sem	know ( winnifred , victor )
Winnifred knows Winnifred	sem	know ( winnifred , winnifred )
Winnifred knows Xerxes	sem	know ( winnifred , xerxes )
Winnifred knows Yvette	sem	know ( winnifred , yvettte )
Winnifred knows Zelda	sem	know ( winnifred , zelda )
Winnifred sees herself	sem	see ( winnifred , winnifred )
Winnifred meets herself	sem	meet ( winnifred , winnifred )
Winnifred likes herself	sem	like ( winnifred , winnifred )
Winnifred dislikes herself	sem	dislike ( winnifred , winnifred )
Winnifred throws herself	sem	throw ( winnifred , winnifred )
Winnifred notices herself	sem	notice ( winnifred , winnifred )
Winnifred knows herself	sem	know ( winnifred , winnifred )
Xerxes sleeps	sem	sleep ( xerxes )
Xerxes sings	sem	sing ( xerxes )
Xerxes dances	sem	dance ( xerxes )
Xerxes flies	sem	fly ( xerxes )
Xerxes slumbers	sem	slumber ( xerxes )
Xerxes sees Bob	sem	see ( xerxes , bob )
Xerxes sees Claire	sem	see ( xerxes , claire )
Xerxes sees Daniel	sem	see ( xerxes , daniel )
Xerxes sees Eliza	sem	see ( xerxes , eliza )
Xerxes sees Henry	sem	see ( xerxes , henry )
Xerxes sees Isla	sem	see ( xerxes , isla )
Xerxes sees Katherine	sem	see ( xerxes , katherine )
Xerxes sees Lewis	sem	see ( xerxes , lewis )
Xerxes sees Margaret	sem	see ( xerxes , margaret )
Xerxes sees Neha	sem	see ( xerxes , neha )
Xerxes sees Oswald	sem	see ( xerxes , oswald )
Xerxes sees Patricia	sem	see ( xerxes , patricia )
Xerxes sees Rachael	sem	see ( xerxes , rachael )
Xerxes sees Samuel	sem	see ( xerxes , samuel )
Xerxes sees Tracy	sem	see ( xerxes , tracy )
Xerxes sees Ursula	sem	see ( xerxes , ursula )
Xerxes sees Xerxes	sem	see ( xerxes , xerxes )
Xerxes sees Yvette	sem	see ( xerxes , yvettte )
Xerxes sees Zelda	sem	see ( xerxes , zelda )
Xerxes meets Bob	sem	meet ( xerxes , bob )
Xerxes meets Daniel	sem	meet ( xerxes , daniel )
Xerxes meets Eliza	sem	meet ( xerxes , eliza )
Xerxes meets Francis	sem	meet ( xerxes , francis )
Xerxes meets Grace	sem	meet ( xerxes , grace )
Xerxes meets Henry	sem	meet ( xerxes , henry )
Xerxes meets Isla	sem	meet ( xerxes , isla )
Xerxes meets John	sem	meet ( xerxes , john )
Xerxes meets Lewis	sem	meet ( xerxes , lewis )
Xerxes meets Margaret	sem	meet ( xerxes , margaret )
Xerxes meets Neha	sem	meet ( xerxes , neha )
Xerxes meets Oswald	sem	meet ( xerxes , oswald )
Xerxes meets Patricia	sem	meet ( xerxes , patricia )
Xerxes meets Quinn	sem	meet ( xerxes , quinn )
Xerxes meets Rachael	sem	meet ( xerxes , rachael )
Xerxes meets Samuel	sem	meet ( xerxes , samuel )
Xerxes meets Ursula	sem	meet ( xerxes , ursula )
Xerxes meets Winnifred	sem	meet ( xerxes , winnifred )
Xerxes meets Xerxes	sem	meet ( xerxes , xerxes )
Xerxes meets Yvette	sem	meet ( xerxes , yvettte )
Xerxes meets Zelda	sem	meet ( xerxes , zelda )
Xerxes likes Bob	sem	like ( xerxes , bob )
Xerxes likes Daniel	sem	like ( xerxes , daniel )
Xerxes likes Eliza	sem	like ( xerxes , eliza )
Xerxes likes Francis	sem	like ( xerxes , francis )
Xerxes likes Grace	sem	like ( xerxes , grace )
Xerxes likes Henry	sem	like ( xerxes , henry )
Xerxes likes Isla	sem	like ( xerxes , isla )
Xerxes likes John	sem	like ( xerxes , john )
Xerxes likes Katherine	sem	like ( xerxes , katherine )
Xerxes likes Lewis	sem	like ( xerxes , lewis )
Xerxes likes Margaret	sem	like ( xerxes , margaret )
Xerxes likes Neha	sem	like ( xerxes , neha )
Xerxes likes Oswald	sem	like ( xerxes , oswald )
Xerxes likes Patricia	sem	like ( xerxes , patricia )
Xerxes likes Rachael	sem	like ( xerxes , rachael )
Xerxes likes Ursula	sem	like ( xerxes , ursula )
Xerxes likes Victor	sem	like ( xerxes , victor )
Xerxes likes Xerxes	sem	like ( xerxes , xerxes )
Xerxes likes Zelda	sem	like ( xerxes , zelda )
Xerxes dislikes Bob	sem	dislike ( xerxes , bob )
Xerxes dislikes Daniel	sem	dislike ( xerxes , daniel )
Xerxes dislikes Grace	sem	dislike ( xerxes , grace )
Xerxes dislikes Henry	sem	dislike ( xerxes , henry )
Xerxes dislikes Isla	sem	dislike ( xerxes , isla )
Xerxes dislikes Lewis	sem	dislike ( xerxes , lewis )
Xerxes dislikes Margaret	sem	dislike ( xerxes , margaret )
Xerxes dislikes Neha	sem	dislike ( xerxes , neha )
Xerxes dislikes Quinn	sem	dislike ( xerxes , quinn )
Xerxes dislikes Samuel	sem	dislike ( xerxes , samuel )
Xerxes dislikes Tracy	sem	dislike ( xerxes , tracy )
Xerxes dislikes Ursula	sem	dislike ( xerxes , ursula )
Xerxes dislikes Victor	sem	dislike ( xerxes , victor )
Xerxes dislikes Xerxes	sem	dislike ( xerxes , xerxes )
Xerxes dislikes Zelda	sem	dislike ( xerxes , zelda )
Xerxes throws Bob	sem	throw ( xerxes , bob )
Xerxes throws Claire	sem	throw ( xerxes , claire )
Xerxes throws Daniel	sem	throw ( xerxes , daniel )
Xerxes throws Eliza	sem	throw ( xerxes , eliza )
Xerxes throws Francis	sem	throw ( xerxes , francis )
Xerxes throws Grace	sem	throw ( xerxes , grace )
Xerxes throws Henry	sem	throw ( xerxes , henry )
Xerxes throws Isla	sem	throw ( xerxes , isla )
Xerxes throws John	sem	throw ( xerxes , john )
Xerxes throws Katherine	sem	throw ( xerxes , katherine )
Xerxes throws Lewis	sem	throw ( xerxes , lewis )
Xerxes throws Margaret	sem	throw ( xerxes , margaret )
Xerxes throws Neha	sem	throw ( xerxes , neha )
Xerxes throws Oswald	sem	throw ( xerxes , oswald )
Xerxes throws Patricia	sem	throw ( xerxes , patricia )
Xerxes throws Rachael	sem	throw ( xerxes , rachael )
Xerxes throws Samuel	sem	throw ( xerxes , samuel )
Xerxes throws Tracy	sem	throw ( xerxes , tracy )
Xerxes throws Ursula	sem	throw ( xerxes , ursula )
Xerxes throws Winnifred	sem	throw ( xerxes , winnifred )
Xerxes throws Xerxes	sem	throw ( xerxes , xerxes )
Xerxes throws Yvette	sem	throw ( xerxes , yvettte )
Xerxes throws Zelda	sem	throw ( xerxes , zelda )
Xerxes notices Bob	sem	notice ( xerxes , bob )
Xerxes notices Claire	sem	notice ( xerxes , claire )
Xerxes notices Daniel	sem	notice ( xerxes , daniel )
Xerxes notices Eliza	sem	notice ( xerxes , eliza )
Xerxes notices Francis	sem	notice ( xerxes , francis )
Xerxes notices Grace	sem	notice ( xerxes , grace )
Xerxes notices Henry	sem	notice ( xerxes , henry )
Xerxes notices Isla	sem	notice ( xerxes , isla )
Xerxes notices John	sem	notice ( xerxes , john )
Xerxes notices Katherine	sem	notice ( xerxes , katherine )
Xerxes notices Lewis	sem	notice ( xerxes , lewis )
Xerxes notices Margaret	sem	notice ( xerxes , margaret )
Xerxes notices Oswald	sem	notice ( xerxes , oswald )
Xerxes notices Patricia	sem	notice ( xerxes , patricia )
Xerxes notices Quinn	sem	notice ( xerxes , quinn )
Xerxes notices Rachael	sem	notice ( xerxes , rachael )
Xerxes notices Samuel	sem	notice ( xerxes , samuel )
Xerxes notices Tracy	sem	notice ( xerxes , tracy )
Xerxes notices Ursula	sem	notice ( xerxes , ursula )
Xerxes notices Victor	sem	notice ( xerxes , victor )
Xerxes notices Winnifred	sem	notice ( xerxes , winnifred )
Xerxes notices Xerxes	sem	notice ( xerxes , xerxes )
Xerxes notices Yvette	sem	notice ( xerxes , yvettte )
Xerxes notices Zelda	sem	notice ( xerxes , zelda )
Xerxes knows Bob	sem	know ( xerxes , bob )
Xerxes knows Claire	sem	know ( xerxes , claire )
Xerxes knows Daniel	sem	know ( xerxes , daniel )
Xerxes knows Eliza	sem	know ( xerxes , eliza )
Xerxes knows Francis	sem	know ( xerxes , francis )
Xerxes knows Grace	sem	know ( xerxes , grace )
Xerxes knows Henry	sem	know ( xerxes , henry )
Xerxes knows John	sem	know ( xerxes , john )
Xerxes knows Lewis	sem	know ( xerxes , lewis )
Xerxes knows Margaret	sem	know ( xerxes , margaret )
Xerxes knows Patricia	sem	know ( xerxes , patricia )
Xerxes knows Quinn	sem	know ( xerxes , quinn )
Xerxes knows Samuel	sem	know ( xerxes , samuel )
Xerxes knows Tracy	sem	know ( xerxes , tracy )
Xerxes knows Ursula	sem	know ( xerxes , ursula )
Xerxes knows Victor	sem	know ( xerxes , victor )
Xerxes knows Xerxes	sem	know ( xerxes , xerxes )
Xerxes knows Yvette	sem	know ( xerxes , yvettte )
Xerxes knows Zelda	sem	know ( xerxes , zelda )
Xerxes likes himself	sem	like ( xerxes , xerxes )
Xerxes dislikes himself	sem	dislike ( xerxes , xerxes )
Xerxes throws himself	sem	throw ( xerxes , xerxes )
Xerxes notices himself	sem	notice ( xerxes , xerxes )
Yvette walks	sem	walk ( yvettte )
Yvette eats	sem	eat ( yvettte )
Yvette runs	sem	run ( yvettte )
Yvette sings	sem	sing ( yvettte )
Yvette slumbers	sem	slumber ( yvettte )
Yvette sees Claire	sem	see ( yvettte , claire )
Yvette sees Daniel	sem	see ( yvettte , daniel )
Yvette sees Eliza	sem	see ( yvettte , eliza )
Yvette sees Francis	sem	see ( yvettte , francis )
Yvette sees Henry	sem	see ( yvettte , henry )
Yvette sees John	sem	see ( yvettte , john )
Yvette sees Katherine	sem	see ( yvettte , katherine )
Yvette sees Lewis	sem	see ( yvettte , lewis )
Yvette sees Margaret	sem	see ( yvettte , margaret )
Yvette sees Oswald	sem	see ( yvettte , oswald )
Yvette sees Patricia	sem	see ( yvettte , patricia )
Yvette sees Rachael	sem	see ( yvettte , rachael )
Yvette sees Samuel	sem	see ( yvettte , samuel )
Yvette sees Victor	sem	see ( yvettte , victor )
Yvette sees Winnifred	sem	see ( yvettte , winnifred )
Yvette sees Xerxes	sem	see ( yvettte , xerxes )
Yvette sees Yvette	sem	see ( yvettte , yvettte )
Yvette sees Zelda	sem	see ( yvettte , zelda )
Yvette meets Claire	sem	meet ( yvettte , claire )
Yvette meets Daniel	sem	meet ( yvettte , daniel )
Yvette meets Eliza	sem	meet ( yvettte , eliza )
Yvette meets Francis	sem	meet ( yvettte , francis )
Yvette meets Grace	sem	meet ( yvettte , grace )
Yvette meets Henry	sem	meet ( yvettte , henry )
Yvette meets Isla	sem	meet ( yvettte , isla )
Yvette meets John	sem	meet ( yvettte , john )
Yvette meets Katherine	sem	meet ( yvettte , katherine )
Yvette meets Lewis	sem	meet ( yvettte , lewis )
Yvette meets Margaret	sem	meet ( yvettte , margaret )
Yvette meets Neha	sem	meet ( yvettte , neha )
Yvette meets Oswald	sem	meet ( yvettte , oswald )
Yvette meets Quinn	sem	meet ( yvettte , quinn )
Yvette meets Samuel	sem	meet ( yvettte , samuel )
Yvette meets Tracy	sem	meet ( yvettte , tracy )
Yvette meets Ursula	sem	meet ( yvettte , ursula )
Yvette meets Victor	sem	meet ( yvettte , victor )
Yvette meets Winnifred	sem	meet ( yvettte , winnifred )
Yvette meets Xerxes	sem	meet ( yvettte , xerxes )
Yvette meets Yvette	sem	meet ( yvettte , yvettte )
Yvette meets Zelda	sem	meet ( yvettte , zelda )
Yvette likes Claire	sem	like ( yvettte , claire )
Yvette likes Daniel	sem	like ( yvettte , daniel )
Yvette likes Francis	sem	like ( yvettte , francis )
Yvette likes Henry	sem	like ( yvettte , henry )
Yvette likes Isla	sem	like ( yvettte , isla )
Yvette likes John	sem	like ( yvettte , john )
Yvette likes Katherine	sem	like ( yvettte , katherine )
Yvette likes Lewis	sem	like ( yvettte , lewis )
Yvette likes Oswald	sem	like ( yvettte , oswald )
Yvette likes Patricia	sem	like ( yvettte , patricia )
Yvette likes Quinn	sem	like ( yvettte , quinn )
Yvette likes Samuel	sem	like ( yvettte , samuel )
Yvette likes Tracy	sem	like ( yvettte , tracy )
Yvette likes Victor	sem	like ( yvettte , victor )
Yvette likes Winnifred	sem	like ( yvettte , winnifred )
Yvette likes Xerxes	sem	like ( yvettte , xerxes )
Yvette likes Yvette	sem	like ( yvettte , yvettte )
Yvette likes Zelda	sem	like ( yvettte , zelda )
Yvette dislikes Claire	sem	dislike ( yvettte , claire )
Yvette dislikes Daniel	sem	dislike ( yvettte , daniel )
Yvette dislikes Francis	sem	dislike ( yvettte , francis )
Yvette dislikes Grace	sem	dislike ( yvettte , grace )
Yvette dislikes Henry	sem	dislike ( yvettte , henry )
Yvette dislikes Isla	sem	dislike ( yvettte , isla )
Yvette dislikes Lewis	sem	dislike ( yvettte , lewis )
Yvette dislikes Margaret	sem	dislike ( yvettte , margaret )
Yvette dislikes Neha	sem	dislike ( yvettte , neha )
Yvette dislikes Oswald	sem	dislike ( yvettte , oswald )
Yvette dislikes Quinn	sem	dislike ( yvettte , quinn )
Yvette dislikes Rachael	sem	dislike ( yvettte , rachael )
Yvette dislikes Samuel	sem	dislike ( yvettte , samuel )
Yvette dislikes Tracy	sem	dislike ( yvettte , tracy )
Yvette dislikes Winnifred	sem	dislike ( yvettte , winnifred )
Yvette dislikes Zelda	sem	dislike ( yvettte , zelda )
Yvette throws Claire	sem	throw ( yvettte , claire )
Yvette throws Daniel	sem	throw ( yvettte , daniel )
Yvette throws Eliza	sem	throw ( yvettte , eliza )
Yvette throws Francis	sem	throw ( yvettte , francis )
Yvette throws Grace	sem	throw ( yvettte , grace )
Yvette throws Henry	sem	throw ( yvettte , henry )
Yvette throws Isla	sem	throw ( yvettte , isla )
Yvette throws John	sem	throw ( yvettte , john )
Yvette throws Lewis	sem	throw ( yvettte , lewis )
Yvette throws Margaret	sem	throw ( yvettte , margaret )
Yvette throws Neha	sem	throw ( yvettte , neha )
Yvette throws Oswald	sem	throw ( yvettte , oswald )
Yvette throws Patricia	sem	throw ( yvettte , patricia )
Yvette throws Quinn	sem	throw ( yvettte , quinn )
Yvette throws Samuel	sem	throw ( yvettte , samuel )
Yvette throws Tracy	sem	throw ( yvettte , tracy )
Yvette throws Ursula	sem	throw ( yvettte , ursula )
Yvette throws Winnifred	sem	throw ( yvettte , winnifred )
Yvette throws Xerxes	sem	throw ( yvettte , xerxes )
Yvette throws Yvette	sem	throw ( yvettte , yvettte )
Yvette throws Zelda	sem	throw ( yvettte , zelda )
Yvette notices Daniel	sem	notice ( yvettte , daniel )
Yvette notices Eliza	sem	notice ( yvettte , eliza )
Yvette notices Francis	sem	notice ( yvettte , francis )
Yvette notices Grace	sem	notice ( yvettte , grace )
Yvette notices Henry	sem	notice ( yvettte , henry )
Yvette notices Isla	sem	notice ( yvettte , isla )
Yvette notices John	sem	notice ( yvettte , john )
Yvette notices Katherine	sem	notice ( yvettte , katherine )
Yvette notices Lewis	sem	notice ( yvettte , lewis )
Yvette notices Margaret	sem	notice ( yvettte , margaret )
Yvette notices Oswald	sem	notice ( yvettte , oswald )
Yvette notices Patricia	sem	notice ( yvettte , patricia )
Yvette notices Quinn	sem	notice ( yvettte , quinn )
Yvette notices Rachael	sem	notice ( yvettte , rachael )
Yvette notices Samuel	sem	notice ( yvettte , samuel )
Yvette notices Tracy	sem	notice ( yvettte , tracy )
Yvette notices Ursula	sem	notice ( yvettte , ursula )
Yvette notices Victor	sem	notice ( yvettte , victor )
Yvette notices Winnifred	sem	notice ( yvettte , winnifred )
Yvette notices Xerxes	sem	notice ( yvettte , xerxes )
Yvette notices Yvette	sem	notice ( yvettte , yvettte )
Yvette notices Zelda	sem	notice ( yvettte , zelda )
Yvette knows Claire	sem	know ( yvettte , claire )
Yvette knows Daniel	sem	know ( yvettte , daniel )
Yvette knows Eliza	sem	know ( yvettte , eliza )
Yvette knows Francis	sem	know ( yvettte , francis )
Yvette knows Grace	sem	know ( yvettte , grace )
Yvette knows Henry	sem	know ( yvettte , henry )
Yvette knows Isla	sem	know ( yvettte , isla )
Yvette knows John	sem	know ( yvettte , john )
Yvette knows Lewis	sem	know ( yvettte , lewis )
Yvette knows Neha	sem	know ( yvettte , neha )
Yvette knows Patricia	sem	know ( yvettte , patricia )
Yvette knows Quinn	sem	know ( yvettte , quinn )
Yvette knows Rachael	sem	know ( yvettte , rachael )
Yvette knows Samuel	sem	know ( yvettte , samuel )
Yvette knows Tracy	sem	know ( yvettte , tracy )
Yvette knows Ursula	sem	know ( yvettte , ursula )
Yvette knows Winnifred	sem	know ( yvettte , winnifred )
Yvette knows Zelda	sem	know ( yvettte , zelda )
Yvette sees herself	sem	see ( yvettte , yvettte )
Yvette meets herself	sem	meet ( yvettte , yvettte )
Yvette likes herself	sem	like ( yvettte , yvettte )
Yvette dislikes herself	sem	dislike ( yvettte , yvettte )
Yvette throws herself	sem	throw ( yvettte , yvettte )
Yvette notices herself	sem	notice ( yvettte , yvettte )
Yvette knows herself	sem	know ( yvettte , yvettte )
Zelda walks	sem	walk ( zelda )
Zelda sleeps	sem	sleep ( zelda )
Zelda eats	sem	eat ( zelda )
Zelda runs	sem	run ( zelda )
Zelda sings	sem	sing ( zelda )
Zelda dances	sem	dance ( zelda )
Zelda flies	sem	fly ( zelda )
Zelda slumbers	sem	slumber ( zelda )
Zelda sees Bob	sem	see ( zelda , bob )
Zelda sees Claire	sem	see ( zelda , claire )
Zelda sees Daniel	sem	see ( zelda , daniel )
Zelda sees Eliza	sem	see ( zelda , eliza )
Zelda sees Francis	sem	see ( zelda , francis )
Zelda sees Grace	sem	see ( zelda , grace )
Zelda sees Isla	sem	see ( zelda , isla )
Zelda sees John	sem	see ( zelda , john )
Zelda sees Katherine	sem	see ( zelda , katherine )
Zelda sees Lewis	sem	see ( zelda , lewis )
Zelda sees Margaret	sem	see ( zelda , margaret )
Zelda sees Oswald	sem	see ( zelda , oswald )
Zelda sees Patricia	sem	see ( zelda , patricia )
Zelda sees Rachael	sem	see ( zelda , rachael )
Zelda sees Samuel	sem	see ( zelda , samuel )
Zelda sees Tracy	sem	see ( zelda , tracy )
Zelda sees Winnifred	sem	see ( zelda , winnifred )
Zelda sees Xerxes	sem	see ( zelda , xerxes )
Zelda sees Yvette	sem	see ( zelda , yvettte )
Zelda sees Zelda	sem	see ( zelda , zelda )
Zelda meets Bob	sem	meet ( zelda , bob )
Zelda meets Claire	sem	meet ( zelda , claire )
Zelda meets Daniel	sem	meet ( zelda , daniel )
Zelda meets Eliza	sem	meet ( zelda , eliza )
Zelda meets Grace	sem	meet ( zelda , grace )
Zelda meets Henry	sem	meet ( zelda , henry )
Zelda meets Isla	sem	meet ( zelda , isla )
Zelda meets John	sem	meet ( zelda , john )
Zelda meets Katherine	sem	meet ( zelda , katherine )
Zelda meets Neha	sem	meet ( zelda , neha )
Zelda meets Oswald	sem	meet ( zelda , oswald )
Zelda meets Quinn	sem	meet ( zelda , quinn )
Zelda meets Rachael	sem	meet ( zelda , rachael )
Zelda meets Samuel	sem	meet ( zelda , samuel )
Zelda meets Tracy	sem	meet ( zelda , tracy )
Zelda meets Winnifred	sem	meet ( zelda , winnifred )
Zelda meets Xerxes	sem	meet ( zelda , xerxes )
Zelda meets Yvette	sem	meet ( zelda , yvettte )
Zelda meets Zelda	sem	meet ( zelda , zelda )
Zelda likes Claire	sem	like ( zelda , claire )
Zelda likes Grace	sem	like ( zelda , grace )
Zelda likes Isla	sem	like ( zelda , isla )
Zelda likes John	sem	like ( zelda , john )
Zelda likes Katherine	sem	like ( zelda , katherine )
Zelda likes Lewis	sem	like ( zelda , lewis )
Zelda likes Margaret	sem	like ( zelda , margaret )
Zelda likes Patricia	sem	like ( zelda , patricia )
Zelda likes Quinn	sem	like ( zelda , quinn )
Zelda likes Rachael	sem	like ( zelda , rachael )
Zelda likes Tracy	sem	like ( zelda , tracy )
Zelda likes Ursula	sem	like ( zelda , ursula )
Zelda likes Victor	sem	like ( zelda , victor )
Zelda likes Winnifred	sem	like ( zelda , winnifred )
Zelda likes Xerxes	sem	like ( zelda , xerxes )
Zelda likes Yvette	sem	like ( zelda , yvettte )
Zelda likes Zelda	sem	like ( zelda , zelda )
Zelda dislikes Bob	sem	dislike ( zelda , bob )
Zelda dislikes Claire	sem	dislike ( zelda , claire )
Zelda dislikes Daniel	sem	dislike ( zelda , daniel )
Zelda dislikes Francis	sem	dislike ( zelda , francis )
Zelda dislikes Grace	sem	dislike ( zelda , grace )
Zelda dislikes Henry	sem	dislike ( zelda , henry )
Zelda dislikes Katherine	sem	dislike ( zelda , katherine )
Zelda dislikes Lewis	sem	dislike ( zelda , lewis )
Zelda dislikes Margaret	sem	dislike ( zelda , margaret )
Zelda dislikes Neha	sem	dislike ( zelda , neha )
Zelda dislikes Oswald	sem	dislike ( zelda , oswald )
Zelda dislikes Patricia	sem	dislike ( zelda , patricia )
Zelda dislikes Quinn	sem	dislike ( zelda , quinn )
Zelda dislikes Rachael	sem	dislike ( zelda , rachael )
Zelda dislikes Samuel	sem	dislike ( zelda , samuel )
Zelda dislikes Tracy	sem	dislike ( zelda , tracy )
Zelda dislikes Ursula	sem	dislike ( zelda , ursula )
Zelda dislikes Victor	sem	dislike ( zelda , victor )
Zelda dislikes Winnifred	sem	dislike ( zelda , winnifred )
Zelda dislikes Xerxes	sem	dislike ( zelda , xerxes )
Zelda dislikes Yvette	sem	dislike ( zelda , yvettte )
Zelda dislikes Zelda	sem	dislike ( zelda , zelda )
Zelda throws Bob	sem	throw ( zelda , bob )
Zelda throws Claire	sem	throw ( zelda , claire )
Zelda throws Daniel	sem	throw ( zelda , daniel )
Zelda throws Eliza	sem	throw ( zelda , eliza )
Zelda throws Francis	sem	throw ( zelda , francis )
Zelda throws Grace	sem	throw ( zelda , grace )
Zelda throws Henry	sem	throw ( zelda , henry )
Zelda throws Isla	sem	throw ( zelda , isla )
Zelda throws John	sem	throw ( zelda , john )
Zelda throws Lewis	sem	throw ( zelda , lewis )
Zelda throws Margaret	sem	throw ( zelda , margaret )
Zelda throws Oswald	sem	throw ( zelda , oswald )
Zelda throws Patricia	sem	throw ( zelda , patricia )
Zelda throws Quinn	sem	throw ( zelda , quinn )
Zelda throws Rachael	sem	throw ( zelda , rachael )
Zelda throws Samuel	sem	throw ( zelda , samuel )
Zelda throws Ursula	sem	throw ( zelda , ursula )
Zelda throws Victor	sem	throw ( zelda , victor )
Zelda throws Winnifred	sem	throw ( zelda , winnifred )
Zelda throws Xerxes	sem	throw ( zelda , xerxes )
Zelda throws Zelda	sem	throw ( zelda , zelda )
Zelda notices Bob	sem	notice ( zelda , bob )
Zelda notices Claire	sem	notice ( zelda , claire )
Zelda notices Francis	sem	notice ( zelda , francis )
Zelda notices Grace	sem	notice ( zelda , grace )
Zelda notices Henry	sem	notice ( zelda , henry )
Zelda notices Isla	sem	notice ( zelda , isla )
Zelda notices John	sem	notice ( zelda , john )
Zelda notices Lewis	sem	notice ( zelda , lewis )
Zelda notices Margaret	sem	notice ( zelda , margaret )
Zelda notices Neha	sem	notice ( zelda , neha )
Zelda notices Oswald	sem	notice ( zelda , oswald )
Zelda notices Patricia	sem	notice ( zelda , patricia )
Zelda notices Quinn	sem	notice ( zelda , quinn )
Zelda notices Rachael	sem	notice ( zelda , rachael )
Zelda notices Samuel	sem	notice ( zelda , samuel )
Zelda notices Tracy	sem	notice ( zelda , tracy )
Zelda notices Victor	sem	notice ( zelda , victor )
Zelda notices Winnifred	sem	notice ( zelda , winnifred )
Zelda notices Xerxes	sem	notice ( zelda , xerxes )
Zelda notices Yvette	sem	notice ( zelda , yvettte )
Zelda notices Zelda	sem	notice ( zelda , zelda )
Zelda knows Bob	sem	know ( zelda , bob )
Zelda knows Claire	sem	know ( zelda , claire )
Zelda knows Daniel	sem	know ( zelda , daniel )
Zelda knows Francis	sem	know ( zelda , francis )
Zelda knows Grace	sem	know ( zelda , grace )
Zelda knows Isla	sem	know ( zelda , isla )
Zelda knows John	sem	know ( zelda , john )
Zelda knows Lewis	sem	know ( zelda , lewis )
Zelda knows Margaret	sem	know ( zelda , margaret )
Zelda knows Neha	sem	know ( zelda , neha )
Zelda knows Oswald	sem	know ( zelda , oswald )
Zelda knows Patricia	sem	know ( zelda , patricia )
Zelda knows Samuel	sem	know ( zelda , samuel )
Zelda knows Ursula	sem	know ( zelda , ursula )
Zelda knows Victor	sem	know ( zelda , victor )
Zelda knows Winnifred	sem	know ( zelda , winnifred )
Zelda knows Xerxes	sem	know ( zelda , xerxes )
Zelda knows Yvette	sem	know ( zelda , yvettte )
Zelda knows Zelda	sem	know ( zelda , zelda )
Zelda meets herself	sem	meet ( zelda , zelda )
Zelda notices herself	sem	notice ( zelda , zelda )
Zelda knows herself	sem	know ( zelda , zelda )
