source	target	prediction
margaret dislikes bob <eos>	dislike ( margaret , bob ) <eos>	dislike ( margaret , bob ) <eos>
eliza likes eliza <eos>	like ( eliza , eliza ) <eos>	like ( eliza , eliza ) <eos>
oswald notices winnifred <eos>	notice ( oswald , winnifred ) <eos>	notice ( oswald , winnifred ) <eos>
alice throws patricia <eos>	throw ( alice , patricia ) <eos>	throw ( alice , patricia ) <eos>
xerxes likes daniel <eos>	like ( xerxes , daniel ) <eos>	like ( xerxes , daniel ) <eos>
alice likes herself <eos>	like ( alice , alice ) <eos>	like ( alice , alice ) <eos>
patricia sees zelda <eos>	see ( patricia , zelda ) <eos>	see ( patricia , zelda ) <eos>
bob dislikes yvette <eos>	dislike ( bob , yvettte ) <eos>	dislike ( bob , yvettte ) <eos>
neha notices patricia <eos>	notice ( neha , patricia ) <eos>	notice ( neha , patricia ) <eos>
margaret likes margaret <eos>	like ( margaret , margaret ) <eos>	like ( margaret , margaret ) <eos>
alice sees tracy <eos>	see ( alice , tracy ) <eos>	see ( alice , tracy ) <eos>
quinn notices daniel <eos>	notice ( quinn , daniel ) <eos>	notice ( quinn , daniel ) <eos>
claire throws claire <eos>	throw ( claire , claire ) <eos>	throw ( claire , claire ) <eos>
grace sees katherine <eos>	see ( grace , katherine ) <eos>	see ( grace , katherine ) <eos>
margaret sees grace <eos>	see ( margaret , grace ) <eos>	see ( margaret , grace ) <eos>
victor meets margaret <eos>	meet ( victor , margaret ) <eos>	meet ( victor , margaret ) <eos>
zelda knows quinn <eos>	know ( zelda , quinn ) <eos>	know ( zelda , quinn ) <eos>
bob sees yvette <eos>	see ( bob , yvettte ) <eos>	see ( bob , yvettte ) <eos>
tracy dislikes katherine <eos>	dislike ( tracy , katherine ) <eos>	dislike ( tracy , katherine ) <eos>
daniel notices lewis <eos>	notice ( daniel , lewis ) <eos>	notice ( daniel , lewis ) <eos>
yvette likes katherine <eos>	like ( yvettte , katherine ) <eos>	like ( yvettte , katherine ) <eos>
patricia likes oswald <eos>	like ( patricia , oswald ) <eos>	like ( patricia , oswald ) <eos>
lewis sees alice <eos>	see ( lewis , alice ) <eos>	see ( lewis , alice ) <eos>
samuel dislikes himself <eos>	dislike ( samuel , samuel ) <eos>	dislike ( samuel , samuel ) <eos>
grace likes oswald <eos>	like ( grace , oswald ) <eos>	like ( grace , oswald ) <eos>
claire likes herself <eos>	like ( claire , claire ) <eos>	like ( claire , claire ) <eos>
margaret notices alice <eos>	notice ( margaret , alice ) <eos>	notice ( margaret , alice ) <eos>
alice sees john <eos>	see ( alice , john ) <eos>	see ( alice , john ) <eos>
alice throws henry <eos>	throw ( alice , henry ) <eos>	throw ( alice , henry ) <eos>
neha notices ursula <eos>	notice ( neha , ursula ) <eos>	notice ( neha , ursula ) <eos>
katherine likes daniel <eos>	like ( katherine , daniel ) <eos>	like ( katherine , daniel ) <eos>
zelda knows yvette <eos>	know ( zelda , yvettte ) <eos>	know ( zelda , yvettte ) <eos>
neha dislikes rachael <eos>	dislike ( neha , rachael ) <eos>	dislike ( neha , rachael ) <eos>
winnifred notices isla <eos>	notice ( winnifred , isla ) <eos>	notice ( winnifred , isla ) <eos>
xerxes notices grace <eos>	notice ( xerxes , grace ) <eos>	notice ( xerxes , grace ) <eos>
zelda notices samuel <eos>	notice ( zelda , samuel ) <eos>	notice ( zelda , samuel ) <eos>
samuel notices himself <eos>	notice ( samuel , samuel ) <eos>	notice ( samuel , samuel ) <eos>
bob notices quinn <eos>	notice ( bob , quinn ) <eos>	notice ( bob , quinn ) <eos>
grace meets xerxes <eos>	meet ( grace , xerxes ) <eos>	meet ( grace , xerxes ) <eos>
bob meets isla <eos>	meet ( bob , isla ) <eos>	meet ( bob , isla ) <eos>
patricia throws xerxes <eos>	throw ( patricia , xerxes ) <eos>	throw ( patricia , xerxes ) <eos>
grace knows herself <eos>	know ( grace , grace ) <eos>	know ( grace , grace ) <eos>
claire notices john <eos>	notice ( claire , john ) <eos>	notice ( claire , john ) <eos>
oswald sees victor <eos>	see ( oswald , victor ) <eos>	see ( oswald , victor ) <eos>
francis dislikes henry <eos>	dislike ( francis , henry ) <eos>	dislike ( francis , henry ) <eos>
yvette notices quinn <eos>	notice ( yvettte , quinn ) <eos>	notice ( yvettte , quinn ) <eos>
isla meets quinn <eos>	meet ( isla , quinn ) <eos>	meet ( isla , quinn ) <eos>
oswald throws yvette <eos>	throw ( oswald , yvettte ) <eos>	throw ( oswald , yvettte ) <eos>
john knows eliza <eos>	know ( john , eliza ) <eos>	know ( john , eliza ) <eos>
claire dislikes lewis <eos>	dislike ( claire , lewis ) <eos>	dislike ( claire , lewis ) <eos>
yvette meets oswald <eos>	meet ( yvettte , oswald ) <eos>	meet ( yvettte , oswald ) <eos>
tracy dislikes claire <eos>	dislike ( tracy , claire ) <eos>	dislike ( tracy , claire ) <eos>
john throws henry <eos>	throw ( john , henry ) <eos>	throw ( john , henry ) <eos>
victor notices margaret <eos>	notice ( victor , margaret ) <eos>	notice ( victor , margaret ) <eos>
ursula throws katherine <eos>	throw ( ursula , katherine ) <eos>	throw ( ursula , katherine ) <eos>
claire sees john <eos>	see ( claire , john ) <eos>	see ( claire , john ) <eos>
lewis likes alice <eos>	like ( lewis , alice ) <eos>	like ( lewis , alice ) <eos>
claire meets grace <eos>	meet ( claire , grace ) <eos>	meet ( claire , grace ) <eos>
rachael meets margaret <eos>	meet ( rachael , margaret ) <eos>	meet ( rachael , margaret ) <eos>
bob knows tracy <eos>	know ( bob , tracy ) <eos>	know ( bob , tracy ) <eos>
isla throws victor <eos>	throw ( isla , victor ) <eos>	throw ( isla , victor ) <eos>
lewis notices quinn <eos>	notice ( lewis , quinn ) <eos>	notice ( lewis , quinn ) <eos>
margaret knows winnifred <eos>	know ( margaret , winnifred ) <eos>	know ( margaret , winnifred ) <eos>
eliza notices ursula <eos>	notice ( eliza , ursula ) <eos>	notice ( eliza , ursula ) <eos>
henry notices zelda <eos>	notice ( henry , zelda ) <eos>	notice ( henry , zelda ) <eos>
alice notices herself <eos>	notice ( alice , alice ) <eos>	notice ( alice , alice ) <eos>
alice notices john <eos>	notice ( alice , john ) <eos>	notice ( alice , john ) <eos>
alice meets oswald <eos>	meet ( alice , oswald ) <eos>	meet ( alice , oswald ) <eos>
neha dislikes ursula <eos>	dislike ( neha , ursula ) <eos>	dislike ( neha , ursula ) <eos>
neha meets daniel <eos>	meet ( neha , daniel ) <eos>	meet ( neha , daniel ) <eos>
grace meets francis <eos>	meet ( grace , francis ) <eos>	meet ( grace , francis ) <eos>
eliza dislikes victor <eos>	dislike ( eliza , victor ) <eos>	dislike ( eliza , victor ) <eos>
eliza dislikes oswald <eos>	dislike ( eliza , oswald ) <eos>	dislike ( eliza , oswald ) <eos>
francis likes quinn <eos>	like ( francis , quinn ) <eos>	like ( francis , quinn ) <eos>
xerxes sees rachael <eos>	see ( xerxes , rachael ) <eos>	see ( xerxes , rachael ) <eos>
john dislikes eliza <eos>	dislike ( john , eliza ) <eos>	dislike ( john , eliza ) <eos>
alice throws alice <eos>	throw ( alice , alice ) <eos>	throw ( alice , alice ) <eos>
claire throws claire <eos>	throw ( claire , claire ) <eos>	throw ( claire , claire ) <eos>
winnifred knows oswald <eos>	know ( winnifred , oswald ) <eos>	know ( winnifred , oswald ) <eos>
grace meets lewis <eos>	meet ( grace , lewis ) <eos>	meet ( grace , lewis ) <eos>
john throws samuel <eos>	throw ( john , samuel ) <eos>	throw ( john , samuel ) <eos>
katherine meets rachael <eos>	meet ( katherine , rachael ) <eos>	meet ( katherine , rachael ) <eos>
patricia likes grace <eos>	like ( patricia , grace ) <eos>	like ( patricia , grace ) <eos>
quinn likes eliza <eos>	like ( quinn , eliza ) <eos>	like ( quinn , eliza ) <eos>
ursula likes alice <eos>	like ( ursula , alice ) <eos>	like ( ursula , alice ) <eos>
john knows victor <eos>	know ( john , victor ) <eos>	know ( john , victor ) <eos>
isla sees john <eos>	see ( isla , john ) <eos>	see ( isla , john ) <eos>
john knows henry <eos>	know ( john , henry ) <eos>	know ( john , henry ) <eos>
grace meets rachael <eos>	meet ( grace , rachael ) <eos>	meet ( grace , rachael ) <eos>
quinn knows isla <eos>	know ( quinn , isla ) <eos>	know ( quinn , isla ) <eos>
neha knows samuel <eos>	know ( neha , samuel ) <eos>	know ( neha , samuel ) <eos>
claire knows zelda <eos>	know ( claire , zelda ) <eos>	know ( claire , zelda ) <eos>
zelda meets john <eos>	meet ( zelda , john ) <eos>	meet ( zelda , john ) <eos>
alice notices neha <eos>	notice ( alice , neha ) <eos>	notice ( alice , neha ) <eos>
henry likes xerxes <eos>	like ( henry , xerxes ) <eos>	like ( henry , xerxes ) <eos>
francis notices zelda <eos>	notice ( francis , zelda ) <eos>	notice ( francis , zelda ) <eos>
isla dislikes neha <eos>	dislike ( isla , neha ) <eos>	dislike ( isla , neha ) <eos>
patricia dislikes claire <eos>	dislike ( patricia , claire ) <eos>	dislike ( patricia , claire ) <eos>
tracy dislikes quinn <eos>	dislike ( tracy , quinn ) <eos>	dislike ( tracy , quinn ) <eos>
ursula throws patricia <eos>	throw ( ursula , patricia ) <eos>	throw ( ursula , patricia ) <eos>
claire meets herself <eos>	meet ( claire , claire ) <eos>	meet ( claire , claire ) <eos>
alice sees claire <eos>	see ( alice , claire ) <eos>	see ( alice , claire ) <eos>
victor throws neha <eos>	throw ( victor , neha ) <eos>	throw ( victor , neha ) <eos>
quinn knows oswald <eos>	know ( quinn , oswald ) <eos>	know ( quinn , oswald ) <eos>
quinn likes daniel <eos>	like ( quinn , daniel ) <eos>	like ( quinn , daniel ) <eos>
eliza throws eliza <eos>	throw ( eliza , eliza ) <eos>	throw ( eliza , eliza ) <eos>
yvette likes francis <eos>	like ( yvettte , francis ) <eos>	like ( yvettte , francis ) <eos>
rachael meets samuel <eos>	meet ( rachael , samuel ) <eos>	meet ( rachael , samuel ) <eos>
claire knows claire <eos>	know ( claire , claire ) <eos>	know ( claire , claire ) <eos>
patricia throws katherine <eos>	throw ( patricia , katherine ) <eos>	throw ( patricia , katherine ) <eos>
grace meets henry <eos>	meet ( grace , henry ) <eos>	meet ( grace , henry ) <eos>
henry knows alice <eos>	know ( henry , alice ) <eos>	know ( henry , alice ) <eos>
isla throws rachael <eos>	throw ( isla , rachael ) <eos>	throw ( isla , rachael ) <eos>
isla meets isla <eos>	meet ( isla , isla ) <eos>	meet ( isla , isla ) <eos>
yvette sees lewis <eos>	see ( yvettte , lewis ) <eos>	see ( yvettte , lewis ) <eos>
isla sings <eos>	sing ( isla ) <eos>	sing ( isla ) <eos>
grace runs <eos>	run ( grace ) <eos>	run ( grace ) <eos>
john walks <eos>	walk ( john ) <eos>	walk ( john ) <eos>
isla eats <eos>	eat ( isla ) <eos>	eat ( isla ) <eos>
oswald sleeps <eos>	sleep ( oswald ) <eos>	sleep ( oswald ) <eos>
francis sees claire <eos>	see ( francis , claire ) <eos>	see ( francis , claire ) <eos>
ursula knows francis <eos>	know ( ursula , francis ) <eos>	know ( ursula , francis ) <eos>
bob likes francis <eos>	like ( bob , francis ) <eos>	like ( bob , francis ) <eos>
victor sees tracy <eos>	see ( victor , tracy ) <eos>	see ( victor , tracy ) <eos>
alice throws herself <eos>	throw ( alice , alice ) <eos>	throw ( alice , alice ) <eos>
xerxes sees winnifred <eos>	see ( xerxes , winnifred ) <eos>	see ( xerxes , winnifred ) <eos>
isla dislikes patricia <eos>	dislike ( isla , patricia ) <eos>	dislike ( isla , patricia ) <eos>
daniel knows tracy <eos>	know ( daniel , tracy ) <eos>	know ( daniel , tracy ) <eos>
grace sees lewis <eos>	see ( grace , lewis ) <eos>	see ( grace , lewis ) <eos>
margaret throws lewis <eos>	throw ( margaret , lewis ) <eos>	throw ( margaret , lewis ) <eos>
rachael knows lewis <eos>	know ( rachael , lewis ) <eos>	know ( rachael , lewis ) <eos>
claire sees herself <eos>	see ( claire , claire ) <eos>	see ( claire , claire ) <eos>
claire meets ursula <eos>	meet ( claire , ursula ) <eos>	meet ( claire , ursula ) <eos>
samuel likes francis <eos>	like ( samuel , francis ) <eos>	like ( samuel , francis ) <eos>
bob dislikes patricia <eos>	dislike ( bob , patricia ) <eos>	dislike ( bob , patricia ) <eos>
claire knows john <eos>	know ( claire , john ) <eos>	know ( claire , john ) <eos>
samuel notices grace <eos>	notice ( samuel , grace ) <eos>	notice ( samuel , grace ) <eos>
zelda likes henry <eos>	like ( zelda , henry ) <eos>	like ( zelda , henry ) <eos>
eliza dislikes herself <eos>	dislike ( eliza , eliza ) <eos>	dislike ( eliza , eliza ) <eos>
john throws winnifred <eos>	throw ( john , winnifred ) <eos>	throw ( john , winnifred ) <eos>
bob dislikes francis <eos>	dislike ( bob , francis ) <eos>	dislike ( bob , francis ) <eos>
margaret likes winnifred <eos>	like ( margaret , winnifred ) <eos>	like ( margaret , winnifred ) <eos>
francis knows ursula <eos>	know ( francis , ursula ) <eos>	know ( francis , ursula ) <eos>
tracy notices neha <eos>	notice ( tracy , neha ) <eos>	notice ( tracy , neha ) <eos>
claire throws zelda <eos>	throw ( claire , zelda ) <eos>	throw ( claire , zelda ) <eos>
eliza throws oswald <eos>	throw ( eliza , oswald ) <eos>	throw ( eliza , oswald ) <eos>
zelda notices herself <eos>	notice ( zelda , zelda ) <eos>	notice ( zelda , zelda ) <eos>
francis likes margaret <eos>	like ( francis , margaret ) <eos>	like ( francis , margaret ) <eos>
rachael knows john <eos>	know ( rachael , john ) <eos>	know ( rachael , john ) <eos>
lewis likes xerxes <eos>	like ( lewis , xerxes ) <eos>	like ( lewis , xerxes ) <eos>
quinn notices zelda <eos>	notice ( quinn , zelda ) <eos>	notice ( quinn , zelda ) <eos>
rachael likes neha <eos>	like ( rachael , neha ) <eos>	like ( rachael , neha ) <eos>
bob throws quinn <eos>	throw ( bob , quinn ) <eos>	throw ( bob , quinn ) <eos>
ursula knows lewis <eos>	know ( ursula , lewis ) <eos>	know ( ursula , lewis ) <eos>
isla throws winnifred <eos>	throw ( isla , winnifred ) <eos>	throw ( isla , winnifred ) <eos>
grace likes quinn <eos>	like ( grace , quinn ) <eos>	like ( grace , quinn ) <eos>
winnifred sees herself <eos>	see ( winnifred , winnifred ) <eos>	see ( winnifred , winnifred ) <eos>
xerxes notices xerxes <eos>	notice ( xerxes , xerxes ) <eos>	notice ( xerxes , xerxes ) <eos>
grace sees francis <eos>	see ( grace , francis ) <eos>	see ( grace , francis ) <eos>
claire likes katherine <eos>	like ( claire , katherine ) <eos>	like ( claire , katherine ) <eos>
ursula meets samuel <eos>	meet ( ursula , samuel ) <eos>	meet ( ursula , samuel ) <eos>
samuel sees isla <eos>	see ( samuel , isla ) <eos>	see ( samuel , isla ) <eos>
ursula notices margaret <eos>	notice ( ursula , margaret ) <eos>	notice ( ursula , margaret ) <eos>
eliza throws herself <eos>	throw ( eliza , eliza ) <eos>	throw ( eliza , eliza ) <eos>
alice meets ursula <eos>	meet ( alice , ursula ) <eos>	meet ( alice , ursula ) <eos>
ursula meets lewis <eos>	meet ( ursula , lewis ) <eos>	meet ( ursula , lewis ) <eos>
henry likes alice <eos>	like ( henry , alice ) <eos>	like ( henry , alice ) <eos>
victor sees claire <eos>	see ( victor , claire ) <eos>	see ( victor , claire ) <eos>
victor throws lewis <eos>	throw ( victor , lewis ) <eos>	throw ( victor , lewis ) <eos>
alice sees bob <eos>	see ( alice , bob ) <eos>	see ( alice , bob ) <eos>
francis dislikes alice <eos>	dislike ( francis , alice ) <eos>	dislike ( francis , alice ) <eos>
yvette dislikes daniel <eos>	dislike ( yvettte , daniel ) <eos>	dislike ( yvettte , daniel ) <eos>
patricia meets lewis <eos>	meet ( patricia , lewis ) <eos>	meet ( patricia , lewis ) <eos>
quinn knows grace <eos>	know ( quinn , grace ) <eos>	know ( quinn , grace ) <eos>
katherine likes grace <eos>	like ( katherine , grace ) <eos>	like ( katherine , grace ) <eos>
samuel notices margaret <eos>	notice ( samuel , margaret ) <eos>	notice ( samuel , margaret ) <eos>
ursula likes john <eos>	like ( ursula , john ) <eos>	like ( ursula , john ) <eos>
tracy throws tracy <eos>	throw ( tracy , tracy ) <eos>	throw ( tracy , tracy ) <eos>
neha meets claire <eos>	meet ( neha , claire ) <eos>	meet ( neha , claire ) <eos>
zelda notices winnifred <eos>	notice ( zelda , winnifred ) <eos>	notice ( zelda , winnifred ) <eos>
eliza knows rachael <eos>	know ( eliza , rachael ) <eos>	know ( eliza , rachael ) <eos>
oswald sees samuel <eos>	see ( oswald , samuel ) <eos>	see ( oswald , samuel ) <eos>
alice likes victor <eos>	like ( alice , victor ) <eos>	like ( alice , victor ) <eos>
eliza throws patricia <eos>	throw ( eliza , patricia ) <eos>	throw ( eliza , patricia ) <eos>
zelda knows katherine <eos>	know ( zelda , katherine ) <eos>	know ( zelda , katherine ) <eos>
neha meets katherine <eos>	meet ( neha , katherine ) <eos>	meet ( neha , katherine ) <eos>
tracy meets henry <eos>	meet ( tracy , henry ) <eos>	meet ( tracy , henry ) <eos>
eliza sees eliza <eos>	see ( eliza , eliza ) <eos>	see ( eliza , eliza ) <eos>
oswald sees patricia <eos>	see ( oswald , patricia ) <eos>	see ( oswald , patricia ) <eos>
grace sees winnifred <eos>	see ( grace , winnifred ) <eos>	see ( grace , winnifred ) <eos>
rachael notices zelda <eos>	notice ( rachael , zelda ) <eos>	notice ( rachael , zelda ) <eos>
grace throws henry <eos>	throw ( grace , henry ) <eos>	throw ( grace , henry ) <eos>
bob sees bob <eos>	see ( bob , bob ) <eos>	see ( bob , bob ) <eos>
xerxes sees victor <eos>	see ( xerxes , victor ) <eos>	see ( xerxes , victor ) <eos>
katherine sees lewis <eos>	see ( katherine , lewis ) <eos>	see ( katherine , lewis ) <eos>
claire notices isla <eos>	notice ( claire , isla ) <eos>	notice ( claire , isla ) <eos>
winnifred knows yvette <eos>	know ( winnifred , yvettte ) <eos>	know ( winnifred , yvettte ) <eos>
xerxes knows rachael <eos>	know ( xerxes , rachael ) <eos>	know ( xerxes , rachael ) <eos>
claire sees claire <eos>	see ( claire , claire ) <eos>	see ( claire , claire ) <eos>
grace sees patricia <eos>	see ( grace , patricia ) <eos>	see ( grace , patricia ) <eos>
lewis sees winnifred <eos>	see ( lewis , winnifred ) <eos>	see ( lewis , winnifred ) <eos>
xerxes dislikes samuel <eos>	dislike ( xerxes , samuel ) <eos>	dislike ( xerxes , samuel ) <eos>
katherine likes eliza <eos>	like ( katherine , eliza ) <eos>	like ( katherine , eliza ) <eos>
margaret likes daniel <eos>	like ( margaret , daniel ) <eos>	like ( margaret , daniel ) <eos>
claire dislikes herself <eos>	dislike ( claire , claire ) <eos>	dislike ( claire , claire ) <eos>
margaret likes xerxes <eos>	like ( margaret , xerxes ) <eos>	like ( margaret , xerxes ) <eos>
francis dislikes quinn <eos>	dislike ( francis , quinn ) <eos>	dislike ( francis , quinn ) <eos>
john meets oswald <eos>	meet ( john , oswald ) <eos>	meet ( john , oswald ) <eos>
victor meets rachael <eos>	meet ( victor , rachael ) <eos>	meet ( victor , rachael ) <eos>
tracy notices claire <eos>	notice ( tracy , claire ) <eos>	notice ( tracy , claire ) <eos>
oswald throws margaret <eos>	throw ( oswald , margaret ) <eos>	throw ( oswald , margaret ) <eos>
margaret notices daniel <eos>	notice ( margaret , daniel ) <eos>	notice ( margaret , daniel ) <eos>
bob notices alice <eos>	notice ( bob , alice ) <eos>	notice ( bob , alice ) <eos>
quinn sees quinn <eos>	see ( quinn , quinn ) <eos>	see ( quinn , quinn ) <eos>
yvette meets neha <eos>	meet ( yvettte , neha ) <eos>	meet ( yvettte , neha ) <eos>
yvette throws francis <eos>	throw ( yvettte , francis ) <eos>	throw ( yvettte , francis ) <eos>
claire dislikes quinn <eos>	dislike ( claire , quinn ) <eos>	dislike ( claire , quinn ) <eos>
rachael notices john <eos>	notice ( rachael , john ) <eos>	notice ( rachael , john ) <eos>
isla sees neha <eos>	see ( isla , neha ) <eos>	see ( isla , neha ) <eos>
winnifred dislikes daniel <eos>	dislike ( winnifred , daniel ) <eos>	dislike ( winnifred , daniel ) <eos>
patricia sees neha <eos>	see ( patricia , neha ) <eos>	see ( patricia , neha ) <eos>
tracy sees yvette <eos>	see ( tracy , yvettte ) <eos>	see ( tracy , yvettte ) <eos>
xerxes sees neha <eos>	see ( xerxes , neha ) <eos>	see ( xerxes , neha ) <eos>
claire throws katherine <eos>	throw ( claire , katherine ) <eos>	throw ( claire , katherine ) <eos>
alice notices margaret <eos>	notice ( alice , margaret ) <eos>	notice ( alice , margaret ) <eos>
zelda dislikes alice <eos>	dislike ( zelda , alice ) <eos>	dislike ( zelda , alice ) <eos>
daniel meets margaret <eos>	meet ( daniel , margaret ) <eos>	meet ( daniel , margaret ) <eos>
alice throws katherine <eos>	throw ( alice , katherine ) <eos>	throw ( alice , katherine ) <eos>
isla likes neha <eos>	like ( isla , neha ) <eos>	like ( isla , neha ) <eos>
xerxes dislikes bob <eos>	dislike ( xerxes , bob ) <eos>	dislike ( xerxes , bob ) <eos>
margaret meets alice <eos>	meet ( margaret , alice ) <eos>	meet ( margaret , alice ) <eos>
isla dislikes grace <eos>	dislike ( isla , grace ) <eos>	dislike ( isla , grace ) <eos>
claire throws francis <eos>	throw ( claire , francis ) <eos>	throw ( claire , francis ) <eos>
xerxes knows grace <eos>	know ( xerxes , grace ) <eos>	know ( xerxes , grace ) <eos>
grace throws patricia <eos>	throw ( grace , patricia ) <eos>	throw ( grace , patricia ) <eos>
grace sees eliza <eos>	see ( grace , eliza ) <eos>	see ( grace , eliza ) <eos>
samuel meets bob <eos>	meet ( samuel , bob ) <eos>	meet ( samuel , bob ) <eos>
daniel sees oswald <eos>	see ( daniel , oswald ) <eos>	see ( daniel , oswald ) <eos>
margaret meets quinn <eos>	meet ( margaret , quinn ) <eos>	meet ( margaret , quinn ) <eos>
patricia notices isla <eos>	notice ( patricia , isla ) <eos>	notice ( patricia , isla ) <eos>
daniel likes francis <eos>	like ( daniel , francis ) <eos>	like ( daniel , francis ) <eos>
samuel meets margaret <eos>	meet ( samuel , margaret ) <eos>	meet ( samuel , margaret ) <eos>
henry slumbers <eos>	slumber ( henry ) <eos>	slumber ( henry ) <eos>
rachael sings <eos>	sing ( rachael ) <eos>	eat ( eliza ) <eos>
katherine walks <eos>	walk ( katherine ) <eos>	fly ( katherine ) <eos>
lewis sees francis <eos>	see ( lewis , francis ) <eos>	see ( lewis , francis ) <eos>
alice knows herself <eos>	know ( alice , alice ) <eos>	know ( alice , alice ) <eos>
patricia knows victor <eos>	know ( patricia , victor ) <eos>	know ( patricia , victor ) <eos>
eliza throws tracy <eos>	throw ( eliza , tracy ) <eos>	throw ( eliza , tracy ) <eos>
xerxes dislikes winnifred <eos>	dislike ( xerxes , winnifred ) <eos>	dislike ( xerxes , winnifred ) <eos>
zelda throws francis <eos>	throw ( zelda , francis ) <eos>	throw ( zelda , francis ) <eos>
victor meets tracy <eos>	meet ( victor , tracy ) <eos>	meet ( victor , tracy ) <eos>
patricia meets henry <eos>	meet ( patricia , henry ) <eos>	meet ( patricia , henry ) <eos>
john meets rachael <eos>	meet ( john , rachael ) <eos>	meet ( john , rachael ) <eos>
henry meets alice <eos>	meet ( henry , alice ) <eos>	meet ( henry , alice ) <eos>
yvette meets herself <eos>	meet ( yvettte , yvettte ) <eos>	meet ( yvettte , yvettte ) <eos>
victor likes eliza <eos>	like ( victor , eliza ) <eos>	like ( victor , eliza ) <eos>
francis notices yvette <eos>	notice ( francis , yvettte ) <eos>	notice ( francis , yvettte ) <eos>
katherine knows alice <eos>	know ( katherine , alice ) <eos>	know ( katherine , alice ) <eos>
xerxes likes lewis <eos>	like ( xerxes , lewis ) <eos>	like ( xerxes , lewis ) <eos>
tracy notices zelda <eos>	notice ( tracy , zelda ) <eos>	notice ( tracy , zelda ) <eos>
francis sees neha <eos>	see ( francis , neha ) <eos>	see ( francis , neha ) <eos>
eliza sees neha <eos>	see ( eliza , neha ) <eos>	see ( eliza , neha ) <eos>
yvette throws winnifred <eos>	throw ( yvettte , winnifred ) <eos>	throw ( yvettte , winnifred ) <eos>
patricia meets xerxes <eos>	meet ( patricia , xerxes ) <eos>	meet ( patricia , xerxes ) <eos>
lewis meets victor <eos>	meet ( lewis , victor ) <eos>	meet ( lewis , victor ) <eos>
winnifred sees quinn <eos>	see ( winnifred , quinn ) <eos>	see ( winnifred , quinn ) <eos>
margaret dislikes victor <eos>	dislike ( margaret , victor ) <eos>	dislike ( margaret , victor ) <eos>
alice notices grace <eos>	notice ( alice , grace ) <eos>	notice ( alice , grace ) <eos>
ursula knows bob <eos>	know ( ursula , bob ) <eos>	know ( ursula , bob ) <eos>
rachael throws tracy <eos>	throw ( rachael , tracy ) <eos>	throw ( rachael , tracy ) <eos>
john notices ursula <eos>	notice ( john , ursula ) <eos>	notice ( john , ursula ) <eos>
neha likes neha <eos>	like ( neha , neha ) <eos>	like ( neha , neha ) <eos>
oswald meets victor <eos>	meet ( oswald , victor ) <eos>	meet ( oswald , victor ) <eos>
xerxes sees alice <eos>	see ( xerxes , alice ) <eos>	see ( xerxes , alice ) <eos>
rachael sees margaret <eos>	see ( rachael , margaret ) <eos>	see ( rachael , margaret ) <eos>
margaret dislikes zelda <eos>	dislike ( margaret , zelda ) <eos>	dislike ( margaret , zelda ) <eos>
francis knows oswald <eos>	know ( francis , oswald ) <eos>	know ( francis , oswald ) <eos>
isla likes tracy <eos>	like ( isla , tracy ) <eos>	like ( isla , tracy ) <eos>
lewis dislikes himself <eos>	dislike ( lewis , lewis ) <eos>	dislike ( lewis , lewis ) <eos>
zelda likes winnifred <eos>	like ( zelda , winnifred ) <eos>	like ( zelda , winnifred ) <eos>
samuel likes daniel <eos>	like ( samuel , daniel ) <eos>	like ( samuel , daniel ) <eos>
yvette meets quinn <eos>	meet ( yvettte , quinn ) <eos>	meet ( yvettte , quinn ) <eos>
winnifred meets victor <eos>	meet ( winnifred , victor ) <eos>	meet ( winnifred , victor ) <eos>
claire likes isla <eos>	like ( claire , isla ) <eos>	like ( claire , isla ) <eos>
lewis throws lewis <eos>	throw ( lewis , lewis ) <eos>	throw ( lewis , lewis ) <eos>
zelda throws eliza <eos>	throw ( zelda , eliza ) <eos>	throw ( zelda , eliza ) <eos>
xerxes notices john <eos>	notice ( xerxes , john ) <eos>	notice ( xerxes , john ) <eos>
oswald notices john <eos>	notice ( oswald , john ) <eos>	notice ( oswald , john ) <eos>
tracy likes isla <eos>	like ( tracy , isla ) <eos>	like ( tracy , isla ) <eos>
victor likes victor <eos>	like ( victor , victor ) <eos>	like ( victor , victor ) <eos>
john knows patricia <eos>	know ( john , patricia ) <eos>	know ( john , patricia ) <eos>
alice dislikes herself <eos>	dislike ( alice , alice ) <eos>	dislike ( alice , alice ) <eos>
zelda dislikes herself <eos>	dislike ( zelda , zelda ) <eos>	dislike ( zelda , zelda ) <eos>
alice dislikes alice <eos>	dislike ( alice , alice ) <eos>	dislike ( alice , alice ) <eos>
francis knows john <eos>	know ( francis , john ) <eos>	know ( francis , john ) <eos>
patricia throws alice <eos>	throw ( patricia , alice ) <eos>	throw ( patricia , alice ) <eos>
patricia knows katherine <eos>	know ( patricia , katherine ) <eos>	know ( patricia , katherine ) <eos>
daniel throws bob <eos>	throw ( daniel , bob ) <eos>	throw ( daniel , bob ) <eos>
katherine dislikes margaret <eos>	dislike ( katherine , margaret ) <eos>	dislike ( katherine , margaret ) <eos>
henry throws daniel <eos>	throw ( henry , daniel ) <eos>	throw ( henry , daniel ) <eos>
neha meets quinn <eos>	meet ( neha , quinn ) <eos>	meet ( neha , quinn ) <eos>
patricia sees rachael <eos>	see ( patricia , rachael ) <eos>	see ( patricia , rachael ) <eos>
patricia throws grace <eos>	throw ( patricia , grace ) <eos>	throw ( patricia , grace ) <eos>
eliza dislikes margaret <eos>	dislike ( eliza , margaret ) <eos>	dislike ( eliza , margaret ) <eos>
margaret likes neha <eos>	like ( margaret , neha ) <eos>	like ( margaret , neha ) <eos>
victor sees henry <eos>	see ( victor , henry ) <eos>	see ( victor , henry ) <eos>
ursula dislikes ursula <eos>	dislike ( ursula , ursula ) <eos>	dislike ( ursula , ursula ) <eos>
tracy sees herself <eos>	see ( tracy , tracy ) <eos>	see ( tracy , tracy ) <eos>
neha notices grace <eos>	notice ( neha , grace ) <eos>	notice ( neha , grace ) <eos>
henry sees samuel <eos>	see ( henry , samuel ) <eos>	see ( henry , samuel ) <eos>
oswald notices victor <eos>	notice ( oswald , victor ) <eos>	notice ( oswald , victor ) <eos>
henry throws quinn <eos>	throw ( henry , quinn ) <eos>	throw ( henry , quinn ) <eos>
claire likes xerxes <eos>	like ( claire , xerxes ) <eos>	like ( claire , xerxes ) <eos>
tracy throws isla <eos>	throw ( tracy , isla ) <eos>	throw ( tracy , isla ) <eos>
francis likes xerxes <eos>	like ( francis , xerxes ) <eos>	like ( francis , xerxes ) <eos>
alice knows bob <eos>	know ( alice , bob ) <eos>	know ( alice , bob ) <eos>
zelda throws ursula <eos>	throw ( zelda , ursula ) <eos>	throw ( zelda , ursula ) <eos>
oswald sees zelda <eos>	see ( oswald , zelda ) <eos>	see ( oswald , zelda ) <eos>
winnifred notices ursula <eos>	notice ( winnifred , ursula ) <eos>	notice ( winnifred , ursula ) <eos>
samuel throws grace <eos>	throw ( samuel , grace ) <eos>	throw ( samuel , grace ) <eos>
yvette throws oswald <eos>	throw ( yvettte , oswald ) <eos>	throw ( yvettte , oswald ) <eos>
yvette meets katherine <eos>	meet ( yvettte , katherine ) <eos>	meet ( yvettte , katherine ) <eos>
yvette notices xerxes <eos>	notice ( yvettte , xerxes ) <eos>	notice ( yvettte , xerxes ) <eos>
eliza notices eliza <eos>	notice ( eliza , eliza ) <eos>	notice ( eliza , eliza ) <eos>
winnifred dislikes eliza <eos>	dislike ( winnifred , eliza ) <eos>	dislike ( winnifred , eliza ) <eos>
henry dislikes isla <eos>	dislike ( henry , isla ) <eos>	dislike ( henry , isla ) <eos>
oswald meets samuel <eos>	meet ( oswald , samuel ) <eos>	meet ( oswald , samuel ) <eos>
eliza likes quinn <eos>	like ( eliza , quinn ) <eos>	like ( eliza , quinn ) <eos>
john knows rachael <eos>	know ( john , rachael ) <eos>	know ( john , rachael ) <eos>
katherine likes john <eos>	like ( katherine , john ) <eos>	like ( katherine , john ) <eos>
claire dislikes xerxes <eos>	dislike ( claire , xerxes ) <eos>	dislike ( claire , xerxes ) <eos>
victor likes john <eos>	like ( victor , john ) <eos>	like ( victor , john ) <eos>
zelda knows tracy <eos>	know ( zelda , tracy ) <eos>	know ( zelda , tracy ) <eos>
claire notices daniel <eos>	notice ( claire , daniel ) <eos>	notice ( claire , daniel ) <eos>
claire likes yvette <eos>	like ( claire , yvettte ) <eos>	like ( claire , yvettte ) <eos>
rachael meets oswald <eos>	meet ( rachael , oswald ) <eos>	meet ( rachael , oswald ) <eos>
lewis notices john <eos>	notice ( lewis , john ) <eos>	notice ( lewis , john ) <eos>
daniel likes grace <eos>	like ( daniel , grace ) <eos>	like ( daniel , grace ) <eos>
bob knows patricia <eos>	know ( bob , patricia ) <eos>	know ( bob , patricia ) <eos>
isla throws zelda <eos>	throw ( isla , zelda ) <eos>	throw ( isla , zelda ) <eos>
alice likes alice <eos>	like ( alice , alice ) <eos>	like ( alice , alice ) <eos>
margaret sees quinn <eos>	see ( margaret , quinn ) <eos>	see ( margaret , quinn ) <eos>
grace dislikes zelda <eos>	dislike ( grace , zelda ) <eos>	dislike ( grace , zelda ) <eos>
samuel notices daniel <eos>	notice ( samuel , daniel ) <eos>	notice ( samuel , daniel ) <eos>
bob dislikes daniel <eos>	dislike ( bob , daniel ) <eos>	dislike ( bob , daniel ) <eos>
zelda dislikes lewis <eos>	dislike ( zelda , lewis ) <eos>	dislike ( zelda , lewis ) <eos>
daniel knows grace <eos>	know ( daniel , grace ) <eos>	know ( daniel , grace ) <eos>
katherine throws daniel <eos>	throw ( katherine , daniel ) <eos>	throw ( katherine , daniel ) <eos>
yvette likes lewis <eos>	like ( yvettte , lewis ) <eos>	like ( yvettte , lewis ) <eos>
samuel throws oswald <eos>	throw ( samuel , oswald ) <eos>	throw ( samuel , oswald ) <eos>
francis throws daniel <eos>	throw ( francis , daniel ) <eos>	throw ( francis , daniel ) <eos>
katherine dislikes henry <eos>	dislike ( katherine , henry ) <eos>	dislike ( katherine , henry ) <eos>
quinn meets eliza <eos>	meet ( quinn , eliza ) <eos>	meet ( quinn , eliza ) <eos>
isla dislikes lewis <eos>	dislike ( isla , lewis ) <eos>	dislike ( isla , lewis ) <eos>
katherine knows oswald <eos>	know ( katherine , oswald ) <eos>	know ( katherine , oswald ) <eos>
francis sees victor <eos>	see ( francis , victor ) <eos>	see ( francis , victor ) <eos>
winnifred meets alice <eos>	meet ( winnifred , alice ) <eos>	meet ( winnifred , alice ) <eos>
grace sees victor <eos>	see ( grace , victor ) <eos>	see ( grace , victor ) <eos>
john meets himself <eos>	meet ( john , john ) <eos>	meet ( john , john ) <eos>
john dislikes katherine <eos>	dislike ( john , katherine ) <eos>	dislike ( john , katherine ) <eos>
margaret throws grace <eos>	throw ( margaret , grace ) <eos>	throw ( margaret , grace ) <eos>
claire dislikes claire <eos>	dislike ( claire , claire ) <eos>	dislike ( claire , claire ) <eos>
yvette knows lewis <eos>	know ( yvettte , lewis ) <eos>	know ( yvettte , lewis ) <eos>
bob throws henry <eos>	throw ( bob , henry ) <eos>	throw ( bob , henry ) <eos>
alice knows alice <eos>	know ( alice , alice ) <eos>	know ( alice , alice ) <eos>
katherine notices katherine <eos>	notice ( katherine , katherine ) <eos>	notice ( katherine , katherine ) <eos>
tracy likes quinn <eos>	like ( tracy , quinn ) <eos>	like ( tracy , quinn ) <eos>
rachael throws oswald <eos>	throw ( rachael , oswald ) <eos>	throw ( rachael , oswald ) <eos>
zelda likes grace <eos>	like ( zelda , grace ) <eos>	like ( zelda , grace ) <eos>
francis knows victor <eos>	know ( francis , victor ) <eos>	know ( francis , victor ) <eos>
daniel dislikes xerxes <eos>	dislike ( daniel , xerxes ) <eos>	dislike ( daniel , xerxes ) <eos>
zelda notices john <eos>	notice ( zelda , john ) <eos>	notice ( zelda , john ) <eos>
quinn likes samuel <eos>	like ( quinn , samuel ) <eos>	like ( quinn , samuel ) <eos>
neha meets samuel <eos>	meet ( neha , samuel ) <eos>	meet ( neha , samuel ) <eos>
eliza notices herself <eos>	notice ( eliza , eliza ) <eos>	notice ( eliza , eliza ) <eos>
yvette throws claire <eos>	throw ( yvettte , claire ) <eos>	throw ( yvettte , claire ) <eos>
yvette sees henry <eos>	see ( yvettte , henry ) <eos>	see ( yvettte , henry ) <eos>
francis sees lewis <eos>	see ( francis , lewis ) <eos>	see ( francis , lewis ) <eos>
ursula throws xerxes <eos>	throw ( ursula , xerxes ) <eos>	throw ( ursula , xerxes ) <eos>
victor knows lewis <eos>	know ( victor , lewis ) <eos>	know ( victor , lewis ) <eos>
ursula meets margaret <eos>	meet ( ursula , margaret ) <eos>	meet ( ursula , margaret ) <eos>
yvette throws patricia <eos>	throw ( yvettte , patricia ) <eos>	throw ( yvettte , patricia ) <eos>
isla notices margaret <eos>	notice ( isla , margaret ) <eos>	notice ( isla , margaret ) <eos>
quinn notices yvette <eos>	notice ( quinn , yvettte ) <eos>	notice ( quinn , yvettte ) <eos>
margaret meets neha <eos>	meet ( margaret , neha ) <eos>	meet ( margaret , neha ) <eos>
oswald meets himself <eos>	meet ( oswald , oswald ) <eos>	meet ( oswald , oswald ) <eos>
oswald notices bob <eos>	notice ( oswald , bob ) <eos>	notice ( oswald , bob ) <eos>
isla throws henry <eos>	throw ( isla , henry ) <eos>	throw ( isla , henry ) <eos>
alice dislikes henry <eos>	dislike ( alice , henry ) <eos>	dislike ( alice , henry ) <eos>
claire dislikes victor <eos>	dislike ( claire , victor ) <eos>	dislike ( claire , victor ) <eos>
margaret dislikes claire <eos>	dislike ( margaret , claire ) <eos>	dislike ( margaret , claire ) <eos>
patricia dislikes john <eos>	dislike ( patricia , john ) <eos>	dislike ( patricia , john ) <eos>
claire meets claire <eos>	meet ( claire , claire ) <eos>	meet ( claire , claire ) <eos>
isla likes alice <eos>	like ( isla , alice ) <eos>	like ( isla , alice ) <eos>
yvette sleeps <eos>	sleep ( yvettte ) <eos>	sleep ( yvettte ) <eos>
victor sings <eos>	sing ( victor ) <eos>	sing ( victor ) <eos>
xerxes sings <eos>	sing ( xerxes ) <eos>	sing ( xerxes ) <eos>
samuel eats <eos>	eat ( samuel ) <eos>	eat ( samuel ) <eos>
alice eats <eos>	eat ( alice ) <eos>	eat ( alice ) <eos>
eliza knows bob <eos>	know ( eliza , bob ) <eos>	know ( eliza , bob ) <eos>
alice notices xerxes <eos>	notice ( alice , xerxes ) <eos>	notice ( alice , xerxes ) <eos>
winnifred notices yvette <eos>	notice ( winnifred , yvettte ) <eos>	notice ( winnifred , yvettte ) <eos>
patricia dislikes eliza <eos>	dislike ( patricia , eliza ) <eos>	dislike ( patricia , eliza ) <eos>
ursula dislikes francis <eos>	dislike ( ursula , francis ) <eos>	dislike ( ursula , francis ) <eos>
rachael notices yvette <eos>	notice ( rachael , yvettte ) <eos>	notice ( rachael , yvettte ) <eos>
katherine notices quinn <eos>	notice ( katherine , quinn ) <eos>	notice ( katherine , quinn ) <eos>
eliza sees daniel <eos>	see ( eliza , daniel ) <eos>	see ( eliza , daniel ) <eos>
rachael throws victor <eos>	throw ( rachael , victor ) <eos>	throw ( rachael , victor ) <eos>
eliza throws eliza <eos>	throw ( eliza , eliza ) <eos>	throw ( eliza , eliza ) <eos>
xerxes notices daniel <eos>	notice ( xerxes , daniel ) <eos>	notice ( xerxes , daniel ) <eos>
margaret throws zelda <eos>	throw ( margaret , zelda ) <eos>	throw ( margaret , zelda ) <eos>
neha meets tracy <eos>	meet ( neha , tracy ) <eos>	meet ( neha , tracy ) <eos>
claire sees tracy <eos>	see ( claire , tracy ) <eos>	see ( claire , tracy ) <eos>
lewis dislikes francis <eos>	dislike ( lewis , francis ) <eos>	dislike ( lewis , francis ) <eos>
claire knows herself <eos>	know ( claire , claire ) <eos>	know ( claire , claire ) <eos>
claire knows samuel <eos>	know ( claire , samuel ) <eos>	know ( claire , samuel ) <eos>
claire likes oswald <eos>	like ( claire , oswald ) <eos>	like ( claire , oswald ) <eos>
yvette likes tracy <eos>	like ( yvettte , tracy ) <eos>	like ( yvettte , tracy ) <eos>
zelda throws tracy <eos>	throw ( zelda , tracy ) <eos>	throw ( zelda , tracy ) <eos>
grace likes john <eos>	like ( grace , john ) <eos>	like ( grace , john ) <eos>
daniel throws rachael <eos>	throw ( daniel , rachael ) <eos>	throw ( daniel , rachael ) <eos>
bob likes xerxes <eos>	like ( bob , xerxes ) <eos>	like ( bob , xerxes ) <eos>
oswald notices daniel <eos>	notice ( oswald , daniel ) <eos>	notice ( oswald , daniel ) <eos>
rachael throws yvette <eos>	throw ( rachael , yvettte ) <eos>	throw ( rachael , yvettte ) <eos>
isla notices ursula <eos>	notice ( isla , ursula ) <eos>	notice ( isla , ursula ) <eos>
quinn likes claire <eos>	like ( quinn , claire ) <eos>	like ( quinn , claire ) <eos>
eliza likes herself <eos>	like ( eliza , eliza ) <eos>	like ( eliza , eliza ) <eos>
isla sees francis <eos>	see ( isla , francis ) <eos>	see ( isla , francis ) <eos>
xerxes dislikes tracy <eos>	dislike ( xerxes , tracy ) <eos>	dislike ( xerxes , tracy ) <eos>
daniel likes winnifred <eos>	like ( daniel , winnifred ) <eos>	like ( daniel , winnifred ) <eos>
alice dislikes rachael <eos>	dislike ( alice , rachael ) <eos>	dislike ( alice , rachael ) <eos>
alice knows francis <eos>	know ( alice , francis ) <eos>	know ( alice , francis ) <eos>
lewis knows ursula <eos>	know ( lewis , ursula ) <eos>	know ( lewis , ursula ) <eos>
victor knows patricia <eos>	know ( victor , patricia ) <eos>	know ( victor , patricia ) <eos>
grace sees quinn <eos>	see ( grace , quinn ) <eos>	see ( grace , quinn ) <eos>
samuel throws john <eos>	throw ( samuel , john ) <eos>	throw ( samuel , john ) <eos>
daniel dislikes daniel <eos>	dislike ( daniel , daniel ) <eos>	dislike ( daniel , daniel ) <eos>
margaret likes patricia <eos>	like ( margaret , patricia ) <eos>	like ( margaret , patricia ) <eos>
eliza meets victor <eos>	meet ( eliza , victor ) <eos>	meet ( eliza , victor ) <eos>
oswald throws oswald <eos>	throw ( oswald , oswald ) <eos>	throw ( oswald , oswald ) <eos>
xerxes sees xerxes <eos>	see ( xerxes , xerxes ) <eos>	see ( xerxes , xerxes ) <eos>
xerxes likes eliza <eos>	like ( xerxes , eliza ) <eos>	like ( xerxes , eliza ) <eos>
claire notices claire <eos>	notice ( claire , claire ) <eos>	notice ( claire , claire ) <eos>
patricia likes claire <eos>	like ( patricia , claire ) <eos>	like ( patricia , claire ) <eos>
victor throws himself <eos>	throw ( victor , victor ) <eos>	throw ( victor , victor ) <eos>
eliza dislikes eliza <eos>	dislike ( eliza , eliza ) <eos>	dislike ( eliza , eliza ) <eos>
henry notices margaret <eos>	notice ( henry , margaret ) <eos>	notice ( henry , margaret ) <eos>
patricia throws tracy <eos>	throw ( patricia , tracy ) <eos>	throw ( patricia , tracy ) <eos>
lewis dislikes john <eos>	dislike ( lewis , john ) <eos>	dislike ( lewis , john ) <eos>
henry likes tracy <eos>	like ( henry , tracy ) <eos>	like ( henry , tracy ) <eos>
samuel meets daniel <eos>	meet ( samuel , daniel ) <eos>	meet ( samuel , daniel ) <eos>
neha notices henry <eos>	notice ( neha , henry ) <eos>	notice ( neha , henry ) <eos>
bob meets claire <eos>	meet ( bob , claire ) <eos>	meet ( bob , claire ) <eos>
tracy throws francis <eos>	throw ( tracy , francis ) <eos>	throw ( tracy , francis ) <eos>
alice sees zelda <eos>	see ( alice , zelda ) <eos>	see ( alice , zelda ) <eos>
margaret throws rachael <eos>	throw ( margaret , rachael ) <eos>	throw ( margaret , rachael ) <eos>
patricia knows claire <eos>	know ( patricia , claire ) <eos>	know ( patricia , claire ) <eos>
claire likes claire <eos>	like ( claire , claire ) <eos>	like ( claire , claire ) <eos>
quinn sees katherine <eos>	see ( quinn , katherine ) <eos>	see ( quinn , katherine ) <eos>
henry throws alice <eos>	throw ( henry , alice ) <eos>	throw ( henry , alice ) <eos>
daniel throws victor <eos>	throw ( daniel , victor ) <eos>	throw ( daniel , victor ) <eos>
tracy notices francis <eos>	notice ( tracy , francis ) <eos>	notice ( tracy , francis ) <eos>
francis throws isla <eos>	throw ( francis , isla ) <eos>	throw ( francis , isla ) <eos>
eliza knows eliza <eos>	know ( eliza , eliza ) <eos>	know ( eliza , eliza ) <eos>
lewis sees yvette <eos>	see ( lewis , yvettte ) <eos>	see ( lewis , yvettte ) <eos>
john meets victor <eos>	meet ( john , victor ) <eos>	meet ( john , victor ) <eos>
grace sees rachael <eos>	see ( grace , rachael ) <eos>	see ( grace , rachael ) <eos>
samuel notices samuel <eos>	notice ( samuel , samuel ) <eos>	notice ( samuel , samuel ) <eos>
isla dislikes oswald <eos>	dislike ( isla , oswald ) <eos>	dislike ( isla , oswald ) <eos>
xerxes likes claire <eos>	like ( xerxes , claire ) <eos>	like ( xerxes , claire ) <eos>
victor notices patricia <eos>	notice ( victor , patricia ) <eos>	notice ( victor , patricia ) <eos>
yvette sees eliza <eos>	see ( yvettte , eliza ) <eos>	see ( yvettte , eliza ) <eos>
katherine notices winnifred <eos>	notice ( katherine , winnifred ) <eos>	notice ( katherine , winnifred ) <eos>
alice knows henry <eos>	know ( alice , henry ) <eos>	know ( alice , henry ) <eos>
xerxes notices victor <eos>	notice ( xerxes , victor ) <eos>	notice ( xerxes , victor ) <eos>
claire knows katherine <eos>	know ( claire , katherine ) <eos>	know ( claire , katherine ) <eos>
neha meets ursula <eos>	meet ( neha , ursula ) <eos>	meet ( neha , ursula ) <eos>
victor likes ursula <eos>	like ( victor , ursula ) <eos>	like ( victor , ursula ) <eos>
zelda throws henry <eos>	throw ( zelda , henry ) <eos>	throw ( zelda , henry ) <eos>
isla sees grace <eos>	see ( isla , grace ) <eos>	see ( isla , grace ) <eos>
quinn sees zelda <eos>	see ( quinn , zelda ) <eos>	see ( quinn , zelda ) <eos>
ursula likes patricia <eos>	like ( ursula , patricia ) <eos>	like ( ursula , patricia ) <eos>
henry knows isla <eos>	know ( henry , isla ) <eos>	know ( henry , isla ) <eos>
francis likes samuel <eos>	like ( francis , samuel ) <eos>	like ( francis , samuel ) <eos>
grace notices victor <eos>	notice ( grace , victor ) <eos>	notice ( grace , victor ) <eos>
alice dislikes neha <eos>	dislike ( alice , neha ) <eos>	dislike ( alice , neha ) <eos>
zelda throws zelda <eos>	throw ( zelda , zelda ) <eos>	throw ( zelda , zelda ) <eos>
claire likes quinn <eos>	like ( claire , quinn ) <eos>	like ( claire , quinn ) <eos>
tracy meets eliza <eos>	meet ( tracy , eliza ) <eos>	meet ( tracy , eliza ) <eos>
yvette knows xerxes <eos>	know ( yvettte , xerxes ) <eos>	know ( yvettte , xerxes ) <eos>
isla meets john <eos>	meet ( isla , john ) <eos>	meet ( isla , john ) <eos>
daniel throws himself <eos>	throw ( daniel , daniel ) <eos>	throw ( daniel , daniel ) <eos>
patricia likes isla <eos>	like ( patricia , isla ) <eos>	like ( patricia , isla ) <eos>
daniel notices winnifred <eos>	notice ( daniel , winnifred ) <eos>	notice ( daniel , winnifred ) <eos>
margaret sees bob <eos>	see ( margaret , bob ) <eos>	see ( margaret , bob ) <eos>
john sees victor <eos>	see ( john , victor ) <eos>	see ( john , victor ) <eos>
samuel likes eliza <eos>	like ( samuel , eliza ) <eos>	like ( samuel , eliza ) <eos>
eliza meets katherine <eos>	meet ( eliza , katherine ) <eos>	meet ( eliza , katherine ) <eos>
zelda knows grace <eos>	know ( zelda , grace ) <eos>	know ( zelda , grace ) <eos>
xerxes sees eliza <eos>	see ( xerxes , eliza ) <eos>	see ( xerxes , eliza ) <eos>
isla sees tracy <eos>	see ( isla , tracy ) <eos>	see ( isla , tracy ) <eos>
lewis meets francis <eos>	meet ( lewis , francis ) <eos>	meet ( lewis , francis ) <eos>
victor throws victor <eos>	throw ( victor , victor ) <eos>	throw ( victor , victor ) <eos>
daniel throws alice <eos>	throw ( daniel , alice ) <eos>	throw ( daniel , alice ) <eos>
samuel throws daniel <eos>	throw ( samuel , daniel ) <eos>	throw ( samuel , daniel ) <eos>
claire notices victor <eos>	notice ( claire , victor ) <eos>	notice ( claire , victor ) <eos>
henry notices alice <eos>	notice ( henry , alice ) <eos>	notice ( henry , alice ) <eos>
tracy throws zelda <eos>	throw ( tracy , zelda ) <eos>	throw ( tracy , zelda ) <eos>
zelda throws xerxes <eos>	throw ( zelda , xerxes ) <eos>	throw ( zelda , xerxes ) <eos>
bob meets alice <eos>	meet ( bob , alice ) <eos>	meet ( bob , alice ) <eos>
lewis dislikes winnifred <eos>	dislike ( lewis , winnifred ) <eos>	dislike ( lewis , winnifred ) <eos>
alice meets winnifred <eos>	meet ( alice , winnifred ) <eos>	meet ( alice , winnifred ) <eos>
katherine sees isla <eos>	see ( katherine , isla ) <eos>	see ( katherine , isla ) <eos>
eliza sees eliza <eos>	see ( eliza , eliza ) <eos>	see ( eliza , eliza ) <eos>
daniel sees grace <eos>	see ( daniel , grace ) <eos>	see ( daniel , grace ) <eos>
henry dislikes margaret <eos>	dislike ( henry , margaret ) <eos>	dislike ( henry , margaret ) <eos>
neha knows tracy <eos>	know ( neha , tracy ) <eos>	know ( neha , tracy ) <eos>
rachael dislikes herself <eos>	dislike ( rachael , rachael ) <eos>	dislike ( rachael , rachael ) <eos>
isla likes yvette <eos>	like ( isla , yvettte ) <eos>	like ( isla , yvettte ) <eos>
yvette notices lewis <eos>	notice ( yvettte , lewis ) <eos>	notice ( yvettte , lewis ) <eos>
patricia likes margaret <eos>	like ( patricia , margaret ) <eos>	like ( patricia , margaret ) <eos>
ursula sees samuel <eos>	see ( ursula , samuel ) <eos>	see ( ursula , samuel ) <eos>
yvette meets ursula <eos>	meet ( yvettte , ursula ) <eos>	meet ( yvettte , ursula ) <eos>
alice dislikes katherine <eos>	dislike ( alice , katherine ) <eos>	dislike ( alice , katherine ) <eos>
alice sees alice <eos>	see ( alice , alice ) <eos>	see ( alice , alice ) <eos>
alice meets yvette <eos>	meet ( alice , yvettte ) <eos>	meet ( alice , yvettte ) <eos>
katherine likes lewis <eos>	like ( katherine , lewis ) <eos>	like ( katherine , lewis ) <eos>
tracy meets oswald <eos>	meet ( tracy , oswald ) <eos>	meet ( tracy , oswald ) <eos>
winnifred sees zelda <eos>	see ( winnifred , zelda ) <eos>	see ( winnifred , zelda ) <eos>
bob meets zelda <eos>	meet ( bob , zelda ) <eos>	meet ( bob , zelda ) <eos>
lewis throws patricia <eos>	throw ( lewis , patricia ) <eos>	throw ( lewis , patricia ) <eos>
oswald notices katherine <eos>	notice ( oswald , katherine ) <eos>	notice ( oswald , katherine ) <eos>
isla likes patricia <eos>	like ( isla , patricia ) <eos>	like ( isla , patricia ) <eos>
