source	target	prediction
zelda likes patricia <eos>	like ( zelda , patricia ) <eos>	like ( zelda , patricia ) <eos>
francis throws himself <eos>	throw ( francis , francis ) <eos>	throw ( francis , francis ) <eos>
tracy likes henry <eos>	like ( tracy , henry ) <eos>	like ( tracy , henry ) <eos>
claire sees katherine <eos>	see ( claire , katherine ) <eos>	see ( claire , katherine ) <eos>
ursula sees alice <eos>	see ( ursula , alice ) <eos>	see ( ursula , alice ) <eos>
eliza notices eliza <eos>	notice ( eliza , eliza ) <eos>	notice ( eliza , eliza ) <eos>
claire sees herself <eos>	see ( claire , claire ) <eos>	see ( claire , claire ) <eos>
zelda likes tracy <eos>	like ( zelda , tracy ) <eos>	like ( zelda , tracy ) <eos>
ursula knows victor <eos>	know ( ursula , victor ) <eos>	know ( ursula , victor ) <eos>
isla likes katherine <eos>	like ( isla , katherine ) <eos>	like ( isla , katherine ) <eos>
rachael notices bob <eos>	notice ( rachael , bob ) <eos>	notice ( rachael , bob ) <eos>
katherine likes katherine <eos>	like ( katherine , katherine ) <eos>	like ( katherine , katherine ) <eos>
rachael notices xerxes <eos>	notice ( rachael , xerxes ) <eos>	notice ( rachael , xerxes ) <eos>
grace dislikes samuel <eos>	dislike ( grace , samuel ) <eos>	dislike ( grace , samuel ) <eos>
lewis meets lewis <eos>	meet ( lewis , lewis ) <eos>	meet ( lewis , lewis ) <eos>
isla dislikes quinn <eos>	dislike ( isla , quinn ) <eos>	dislike ( isla , quinn ) <eos>
ursula likes herself <eos>	like ( ursula , ursula ) <eos>	like ( ursula , ursula ) <eos>
katherine throws lewis <eos>	throw ( katherine , lewis ) <eos>	throw ( katherine , lewis ) <eos>
winnifred throws katherine <eos>	throw ( winnifred , katherine ) <eos>	throw ( winnifred , katherine ) <eos>
francis throws margaret <eos>	throw ( francis , margaret ) <eos>	throw ( francis , margaret ) <eos>
xerxes dislikes zelda <eos>	dislike ( xerxes , zelda ) <eos>	dislike ( xerxes , zelda ) <eos>
claire throws francis <eos>	throw ( claire , francis ) <eos>	throw ( claire , francis ) <eos>
claire throws ursula <eos>	throw ( claire , ursula ) <eos>	throw ( claire , ursula ) <eos>
neha notices eliza <eos>	notice ( neha , eliza ) <eos>	notice ( neha , eliza ) <eos>
francis meets rachael <eos>	meet ( francis , rachael ) <eos>	meet ( francis , rachael ) <eos>
patricia dislikes quinn <eos>	dislike ( patricia , quinn ) <eos>	dislike ( patricia , quinn ) <eos>
lewis dislikes john <eos>	dislike ( lewis , john ) <eos>	dislike ( lewis , john ) <eos>
patricia dislikes victor <eos>	dislike ( patricia , victor ) <eos>	dislike ( patricia , victor ) <eos>
eliza likes herself <eos>	like ( eliza , eliza ) <eos>	like ( eliza , eliza ) <eos>
samuel meets grace <eos>	meet ( samuel , grace ) <eos>	meet ( samuel , grace ) <eos>
katherine likes zelda <eos>	like ( katherine , zelda ) <eos>	like ( katherine , zelda ) <eos>
oswald knows yvette <eos>	know ( oswald , yvettte ) <eos>	know ( oswald , yvettte ) <eos>
bob throws henry <eos>	throw ( bob , henry ) <eos>	throw ( bob , henry ) <eos>
claire knows bob <eos>	know ( claire , bob ) <eos>	know ( claire , bob ) <eos>
ursula meets eliza <eos>	meet ( ursula , eliza ) <eos>	meet ( ursula , eliza ) <eos>
eliza sees eliza <eos>	see ( eliza , eliza ) <eos>	see ( eliza , eliza ) <eos>
oswald notices neha <eos>	notice ( oswald , neha ) <eos>	notice ( oswald , neha ) <eos>
xerxes knows yvette <eos>	know ( xerxes , yvettte ) <eos>	know ( xerxes , yvettte ) <eos>
alice dislikes henry <eos>	dislike ( alice , henry ) <eos>	dislike ( alice , henry ) <eos>
eliza meets rachael <eos>	meet ( eliza , rachael ) <eos>	meet ( eliza , rachael ) <eos>
tracy meets francis <eos>	meet ( tracy , francis ) <eos>	meet ( tracy , francis ) <eos>
katherine meets winnifred <eos>	meet ( katherine , winnifred ) <eos>	meet ( katherine , winnifred ) <eos>
rachael likes quinn <eos>	like ( rachael , quinn ) <eos>	like ( rachael , quinn ) <eos>
victor notices katherine <eos>	notice ( victor , katherine ) <eos>	notice ( victor , katherine ) <eos>
isla notices isla <eos>	notice ( isla , isla ) <eos>	notice ( isla , isla ) <eos>
quinn throws alice <eos>	throw ( quinn , alice ) <eos>	throw ( quinn , alice ) <eos>
tracy knows claire <eos>	know ( tracy , claire ) <eos>	know ( tracy , claire ) <eos>
isla meets rachael <eos>	meet ( isla , rachael ) <eos>	meet ( isla , rachael ) <eos>
claire dislikes quinn <eos>	dislike ( claire , quinn ) <eos>	dislike ( claire , quinn ) <eos>
francis throws oswald <eos>	throw ( francis , oswald ) <eos>	throw ( francis , oswald ) <eos>
katherine sees katherine <eos>	see ( katherine , katherine ) <eos>	see ( katherine , katherine ) <eos>
lewis knows patricia <eos>	know ( lewis , patricia ) <eos>	know ( lewis , patricia ) <eos>
francis dislikes neha <eos>	dislike ( francis , neha ) <eos>	dislike ( francis , neha ) <eos>
samuel knows oswald <eos>	know ( samuel , oswald ) <eos>	know ( samuel , oswald ) <eos>
henry likes eliza <eos>	like ( henry , eliza ) <eos>	like ( henry , eliza ) <eos>
katherine throws katherine <eos>	throw ( katherine , katherine ) <eos>	throw ( katherine , katherine ) <eos>
bob meets bob <eos>	meet ( bob , bob ) <eos>	meet ( bob , bob ) <eos>
grace likes margaret <eos>	like ( grace , margaret ) <eos>	like ( grace , margaret ) <eos>
grace sees lewis <eos>	see ( grace , lewis ) <eos>	see ( grace , lewis ) <eos>
winnifred dislikes ursula <eos>	dislike ( winnifred , ursula ) <eos>	dislike ( winnifred , ursula ) <eos>
alice throws eliza <eos>	throw ( alice , eliza ) <eos>	throw ( alice , eliza ) <eos>
patricia notices tracy <eos>	notice ( patricia , tracy ) <eos>	notice ( patricia , tracy ) <eos>
grace knows patricia <eos>	know ( grace , patricia ) <eos>	know ( grace , patricia ) <eos>
eliza throws isla <eos>	throw ( eliza , isla ) <eos>	throw ( eliza , isla ) <eos>
francis notices john <eos>	notice ( francis , john ) <eos>	notice ( francis , john ) <eos>
yvette sees oswald <eos>	see ( yvettte , oswald ) <eos>	see ( yvettte , oswald ) <eos>
daniel likes quinn <eos>	like ( daniel , quinn ) <eos>	like ( daniel , quinn ) <eos>
isla likes herself <eos>	like ( isla , isla ) <eos>	like ( isla , victor ) <eos>
oswald throws victor <eos>	throw ( oswald , victor ) <eos>	throw ( oswald , victor ) <eos>
katherine notices herself <eos>	notice ( katherine , katherine ) <eos>	notice ( katherine , katherine ) <eos>
bob knows neha <eos>	know ( bob , neha ) <eos>	know ( bob , neha ) <eos>
victor dislikes margaret <eos>	dislike ( victor , margaret ) <eos>	dislike ( victor , margaret ) <eos>
alice throws herself <eos>	throw ( alice , alice ) <eos>	throw ( alice , alice ) <eos>
daniel meets himself <eos>	meet ( daniel , daniel ) <eos>	meet ( daniel , daniel ) <eos>
bob meets claire <eos>	meet ( bob , claire ) <eos>	meet ( bob , claire ) <eos>
zelda dislikes john <eos>	dislike ( zelda , john ) <eos>	dislike ( zelda , john ) <eos>
lewis dislikes winnifred <eos>	dislike ( lewis , winnifred ) <eos>	dislike ( lewis , winnifred ) <eos>
tracy notices bob <eos>	notice ( tracy , bob ) <eos>	notice ( tracy , bob ) <eos>
isla throws yvette <eos>	throw ( isla , yvettte ) <eos>	throw ( isla , yvettte ) <eos>
tracy meets oswald <eos>	meet ( tracy , oswald ) <eos>	meet ( tracy , oswald ) <eos>
isla throws daniel <eos>	throw ( isla , daniel ) <eos>	throw ( isla , daniel ) <eos>
francis meets samuel <eos>	meet ( francis , samuel ) <eos>	meet ( francis , samuel ) <eos>
quinn likes tracy <eos>	like ( quinn , tracy ) <eos>	like ( quinn , tracy ) <eos>
neha likes rachael <eos>	like ( neha , rachael ) <eos>	like ( neha , rachael ) <eos>
yvette sees quinn <eos>	see ( yvettte , quinn ) <eos>	see ( yvettte , quinn ) <eos>
grace dislikes alice <eos>	dislike ( grace , alice ) <eos>	dislike ( grace , alice ) <eos>
oswald meets yvette <eos>	meet ( oswald , yvettte ) <eos>	meet ( oswald , yvettte ) <eos>
quinn throws himself <eos>	throw ( quinn , quinn ) <eos>	throw ( quinn , quinn ) <eos>
winnifred knows grace <eos>	know ( winnifred , grace ) <eos>	know ( winnifred , grace ) <eos>
grace dislikes grace <eos>	dislike ( grace , grace ) <eos>	dislike ( grace , grace ) <eos>
zelda sees oswald <eos>	see ( zelda , oswald ) <eos>	see ( zelda , oswald ) <eos>
bob sees neha <eos>	see ( bob , neha ) <eos>	see ( bob , neha ) <eos>
claire notices herself <eos>	notice ( claire , claire ) <eos>	notice ( claire , claire ) <eos>
claire throws john <eos>	throw ( claire , john ) <eos>	throw ( claire , john ) <eos>
quinn sees samuel <eos>	see ( quinn , samuel ) <eos>	see ( quinn , samuel ) <eos>
ursula dislikes neha <eos>	dislike ( ursula , neha ) <eos>	dislike ( ursula , neha ) <eos>
alice likes patricia <eos>	like ( alice , patricia ) <eos>	like ( alice , patricia ) <eos>
patricia meets herself <eos>	meet ( patricia , patricia ) <eos>	meet ( patricia , patricia ) <eos>
alice notices herself <eos>	notice ( alice , alice ) <eos>	notice ( alice , alice ) <eos>
eliza knows herself <eos>	know ( eliza , eliza ) <eos>	know ( eliza , eliza ) <eos>
xerxes sees neha <eos>	see ( xerxes , neha ) <eos>	see ( xerxes , neha ) <eos>
winnifred sees henry <eos>	see ( winnifred , henry ) <eos>	see ( winnifred , henry ) <eos>
grace meets herself <eos>	meet ( grace , grace ) <eos>	meet ( grace , grace ) <eos>
tracy sees daniel <eos>	see ( tracy , daniel ) <eos>	see ( tracy , daniel ) <eos>
victor notices samuel <eos>	notice ( victor , samuel ) <eos>	notice ( victor , samuel ) <eos>
xerxes knows tracy <eos>	know ( xerxes , tracy ) <eos>	know ( xerxes , tracy ) <eos>
zelda meets lewis <eos>	meet ( zelda , lewis ) <eos>	meet ( zelda , lewis ) <eos>
yvette sees john <eos>	see ( yvettte , john ) <eos>	see ( yvettte , john ) <eos>
john meets winnifred <eos>	meet ( john , winnifred ) <eos>	meet ( john , winnifred ) <eos>
henry sees samuel <eos>	see ( henry , samuel ) <eos>	see ( henry , samuel ) <eos>
oswald dislikes ursula <eos>	dislike ( oswald , ursula ) <eos>	dislike ( oswald , ursula ) <eos>
francis notices isla <eos>	notice ( francis , isla ) <eos>	notice ( francis , isla ) <eos>
eliza likes eliza <eos>	like ( eliza , eliza ) <eos>	like ( eliza , eliza ) <eos>
neha throws xerxes <eos>	throw ( neha , xerxes ) <eos>	throw ( neha , xerxes ) <eos>
rachael dislikes ursula <eos>	dislike ( rachael , ursula ) <eos>	dislike ( rachael , ursula ) <eos>
grace notices isla <eos>	notice ( grace , isla ) <eos>	notice ( grace , isla ) <eos>
bob meets john <eos>	meet ( bob , john ) <eos>	meet ( bob , john ) <eos>
neha throws francis <eos>	throw ( neha , francis ) <eos>	throw ( neha , francis ) <eos>
daniel dislikes tracy <eos>	dislike ( daniel , tracy ) <eos>	dislike ( daniel , tracy ) <eos>
victor likes yvette <eos>	like ( victor , yvettte ) <eos>	like ( victor , yvettte ) <eos>
isla knows isla <eos>	know ( isla , isla ) <eos>	know ( isla , isla ) <eos>
patricia likes alice <eos>	like ( patricia , alice ) <eos>	like ( patricia , alice ) <eos>
eliza meets tracy <eos>	meet ( eliza , tracy ) <eos>	meet ( eliza , tracy ) <eos>
francis likes bob <eos>	like ( francis , bob ) <eos>	like ( francis , bob ) <eos>
winnifred dislikes patricia <eos>	dislike ( winnifred , patricia ) <eos>	dislike ( winnifred , patricia ) <eos>
katherine dislikes katherine <eos>	dislike ( katherine , katherine ) <eos>	dislike ( katherine , katherine ) <eos>
isla meets herself <eos>	meet ( isla , isla ) <eos>	meet ( isla , zelda ) <eos>
winnifred likes claire <eos>	like ( winnifred , claire ) <eos>	like ( winnifred , claire ) <eos>
isla likes henry <eos>	like ( isla , henry ) <eos>	like ( isla , henry ) <eos>
john likes alice <eos>	like ( john , alice ) <eos>	like ( john , alice ) <eos>
henry knows francis <eos>	know ( henry , francis ) <eos>	know ( henry , francis ) <eos>
samuel dislikes oswald <eos>	dislike ( samuel , oswald ) <eos>	dislike ( samuel , oswald ) <eos>
oswald knows francis <eos>	know ( oswald , francis ) <eos>	know ( oswald , francis ) <eos>
victor dislikes claire <eos>	dislike ( victor , claire ) <eos>	dislike ( victor , claire ) <eos>
isla dislikes herself <eos>	dislike ( isla , isla ) <eos>	dislike ( isla , zelda ) <eos>
isla notices herself <eos>	notice ( isla , isla ) <eos>	notice ( isla , victor ) <eos>
katherine knows herself <eos>	know ( katherine , katherine ) <eos>	know ( katherine , katherine ) <eos>
margaret likes samuel <eos>	like ( margaret , samuel ) <eos>	like ( margaret , samuel ) <eos>
grace knows herself <eos>	know ( grace , grace ) <eos>	know ( grace , grace ) <eos>
patricia meets bob <eos>	meet ( patricia , bob ) <eos>	meet ( patricia , bob ) <eos>
grace meets bob <eos>	meet ( grace , bob ) <eos>	meet ( grace , bob ) <eos>
daniel dislikes john <eos>	dislike ( daniel , john ) <eos>	dislike ( daniel , john ) <eos>
eliza likes bob <eos>	like ( eliza , bob ) <eos>	like ( eliza , bob ) <eos>
katherine throws herself <eos>	throw ( katherine , katherine ) <eos>	throw ( katherine , katherine ) <eos>
grace dislikes herself <eos>	dislike ( grace , grace ) <eos>	dislike ( grace , grace ) <eos>
rachael notices ursula <eos>	notice ( rachael , ursula ) <eos>	notice ( rachael , ursula ) <eos>
tracy meets daniel <eos>	meet ( tracy , daniel ) <eos>	meet ( tracy , daniel ) <eos>
zelda dislikes herself <eos>	dislike ( zelda , zelda ) <eos>	dislike ( zelda , zelda ) <eos>
victor notices henry <eos>	notice ( victor , henry ) <eos>	notice ( victor , henry ) <eos>
patricia meets yvette <eos>	meet ( patricia , yvettte ) <eos>	meet ( patricia , yvettte ) <eos>
alice dislikes alice <eos>	dislike ( alice , alice ) <eos>	dislike ( alice , alice ) <eos>
isla likes grace <eos>	like ( isla , grace ) <eos>	like ( isla , grace ) <eos>
claire sees claire <eos>	see ( claire , claire ) <eos>	see ( claire , claire ) <eos>
claire throws claire <eos>	throw ( claire , claire ) <eos>	throw ( claire , claire ) <eos>
patricia sees john <eos>	see ( patricia , john ) <eos>	see ( patricia , john ) <eos>
grace notices quinn <eos>	notice ( grace , quinn ) <eos>	notice ( grace , quinn ) <eos>
henry dislikes zelda <eos>	dislike ( henry , zelda ) <eos>	dislike ( henry , zelda ) <eos>
claire likes herself <eos>	like ( claire , claire ) <eos>	like ( claire , claire ) <eos>
samuel knows francis <eos>	know ( samuel , francis ) <eos>	know ( samuel , francis ) <eos>
ursula likes alice <eos>	like ( ursula , alice ) <eos>	like ( ursula , alice ) <eos>
samuel knows victor <eos>	know ( samuel , victor ) <eos>	know ( samuel , victor ) <eos>
grace likes winnifred <eos>	like ( grace , winnifred ) <eos>	like ( grace , winnifred ) <eos>
francis sees lewis <eos>	see ( francis , lewis ) <eos>	see ( francis , lewis ) <eos>
samuel dislikes victor <eos>	dislike ( samuel , victor ) <eos>	dislike ( samuel , victor ) <eos>
isla throws herself <eos>	throw ( isla , isla ) <eos>	throw ( isla , victor ) <eos>
xerxes likes john <eos>	like ( xerxes , john ) <eos>	like ( xerxes , john ) <eos>
yvette dislikes patricia <eos>	dislike ( yvettte , patricia ) <eos>	dislike ( yvettte , patricia ) <eos>
zelda likes henry <eos>	like ( zelda , henry ) <eos>	like ( zelda , henry ) <eos>
alice meets alice <eos>	meet ( alice , alice ) <eos>	meet ( alice , alice ) <eos>
zelda knows zelda <eos>	know ( zelda , zelda ) <eos>	know ( zelda , zelda ) <eos>
henry notices tracy <eos>	notice ( henry , tracy ) <eos>	notice ( henry , tracy ) <eos>
winnifred likes rachael <eos>	like ( winnifred , rachael ) <eos>	like ( winnifred , rachael ) <eos>
xerxes likes daniel <eos>	like ( xerxes , daniel ) <eos>	like ( xerxes , daniel ) <eos>
lewis dislikes patricia <eos>	dislike ( lewis , patricia ) <eos>	dislike ( lewis , patricia ) <eos>
winnifred dislikes claire <eos>	dislike ( winnifred , claire ) <eos>	dislike ( winnifred , claire ) <eos>
claire likes henry <eos>	like ( claire , henry ) <eos>	like ( claire , henry ) <eos>
yvette throws bob <eos>	throw ( yvettte , bob ) <eos>	throw ( yvettte , bob ) <eos>
katherine likes victor <eos>	like ( katherine , victor ) <eos>	like ( katherine , victor ) <eos>
eliza dislikes herself <eos>	dislike ( eliza , eliza ) <eos>	dislike ( eliza , eliza ) <eos>
john likes neha <eos>	like ( john , neha ) <eos>	like ( john , neha ) <eos>
patricia throws zelda <eos>	throw ( patricia , zelda ) <eos>	throw ( patricia , zelda ) <eos>
samuel likes victor <eos>	like ( samuel , victor ) <eos>	like ( samuel , victor ) <eos>
francis meets patricia <eos>	meet ( francis , patricia ) <eos>	meet ( francis , patricia ) <eos>
zelda likes zelda <eos>	like ( zelda , zelda ) <eos>	like ( zelda , zelda ) <eos>
samuel throws neha <eos>	throw ( samuel , neha ) <eos>	throw ( samuel , neha ) <eos>
xerxes throws alice <eos>	throw ( xerxes , alice ) <eos>	throw ( xerxes , alice ) <eos>
francis sees ursula <eos>	see ( francis , ursula ) <eos>	see ( francis , ursula ) <eos>
eliza notices claire <eos>	notice ( eliza , claire ) <eos>	notice ( eliza , claire ) <eos>
winnifred likes tracy <eos>	like ( winnifred , tracy ) <eos>	like ( winnifred , tracy ) <eos>
quinn knows grace <eos>	know ( quinn , grace ) <eos>	know ( quinn , grace ) <eos>
john throws tracy <eos>	throw ( john , tracy ) <eos>	throw ( john , tracy ) <eos>
lewis throws francis <eos>	throw ( lewis , francis ) <eos>	throw ( lewis , francis ) <eos>
tracy meets tracy <eos>	meet ( tracy , tracy ) <eos>	meet ( tracy , tracy ) <eos>
oswald sees grace <eos>	see ( oswald , grace ) <eos>	see ( oswald , grace ) <eos>
eliza dislikes eliza <eos>	dislike ( eliza , eliza ) <eos>	dislike ( eliza , eliza ) <eos>
claire sees eliza <eos>	see ( claire , eliza ) <eos>	see ( claire , eliza ) <eos>
oswald notices winnifred <eos>	notice ( oswald , winnifred ) <eos>	notice ( oswald , winnifred ) <eos>
claire sees john <eos>	see ( claire , john ) <eos>	see ( claire , john ) <eos>
yvette throws eliza <eos>	throw ( yvettte , eliza ) <eos>	throw ( yvettte , eliza ) <eos>
ursula likes bob <eos>	like ( ursula , bob ) <eos>	like ( ursula , bob ) <eos>
daniel likes francis <eos>	like ( daniel , francis ) <eos>	like ( daniel , francis ) <eos>
winnifred likes francis <eos>	like ( winnifred , francis ) <eos>	like ( winnifred , francis ) <eos>
tracy notices grace <eos>	notice ( tracy , grace ) <eos>	notice ( tracy , grace ) <eos>
rachael knows neha <eos>	know ( rachael , neha ) <eos>	know ( rachael , neha ) <eos>
margaret knows alice <eos>	know ( margaret , alice ) <eos>	know ( margaret , alice ) <eos>
henry likes zelda <eos>	like ( henry , zelda ) <eos>	like ( henry , zelda ) <eos>
katherine knows katherine <eos>	know ( katherine , katherine ) <eos>	know ( katherine , katherine ) <eos>
daniel knows katherine <eos>	know ( daniel , katherine ) <eos>	know ( daniel , katherine ) <eos>
yvette knows claire <eos>	know ( yvettte , claire ) <eos>	know ( yvettte , claire ) <eos>
daniel dislikes patricia <eos>	dislike ( daniel , patricia ) <eos>	dislike ( daniel , patricia ) <eos>
alice throws grace <eos>	throw ( alice , grace ) <eos>	throw ( alice , grace ) <eos>
quinn sees lewis <eos>	see ( quinn , lewis ) <eos>	see ( quinn , lewis ) <eos>
quinn dislikes himself <eos>	dislike ( quinn , quinn ) <eos>	dislike ( quinn , quinn ) <eos>
zelda sees alice <eos>	see ( zelda , alice ) <eos>	see ( zelda , alice ) <eos>
yvette sees yvette <eos>	see ( yvettte , yvettte ) <eos>	see ( yvettte , yvettte ) <eos>
katherine notices katherine <eos>	notice ( katherine , katherine ) <eos>	notice ( katherine , katherine ) <eos>
eliza dislikes bob <eos>	dislike ( eliza , bob ) <eos>	dislike ( eliza , bob ) <eos>
oswald sleeps <eos>	sleep ( oswald ) <eos>	slumber ( oswald ) <eos>
daniel dances <eos>	dance ( daniel ) <eos>	sleep ( daniel ) <eos>
neha dances <eos>	dance ( neha ) <eos>	sleep ( neha ) <eos>
quinn likes zelda <eos>	like ( quinn , zelda ) <eos>	like ( quinn , zelda ) <eos>
daniel sees eliza <eos>	see ( daniel , eliza ) <eos>	see ( daniel , eliza ) <eos>
neha meets tracy <eos>	meet ( neha , tracy ) <eos>	meet ( neha , tracy ) <eos>
quinn notices claire <eos>	notice ( quinn , claire ) <eos>	notice ( quinn , claire ) <eos>
alice notices alice <eos>	notice ( alice , alice ) <eos>	notice ( alice , alice ) <eos>
daniel knows john <eos>	know ( daniel , john ) <eos>	know ( daniel , john ) <eos>
bob knows ursula <eos>	know ( bob , ursula ) <eos>	know ( bob , ursula ) <eos>
margaret notices rachael <eos>	notice ( margaret , rachael ) <eos>	notice ( margaret , rachael ) <eos>
rachael likes patricia <eos>	like ( rachael , patricia ) <eos>	like ( rachael , patricia ) <eos>
henry notices quinn <eos>	notice ( henry , quinn ) <eos>	notice ( henry , quinn ) <eos>
eliza notices herself <eos>	notice ( eliza , eliza ) <eos>	notice ( eliza , eliza ) <eos>
henry meets claire <eos>	meet ( henry , claire ) <eos>	meet ( henry , claire ) <eos>
alice meets eliza <eos>	meet ( alice , eliza ) <eos>	meet ( alice , eliza ) <eos>
winnifred notices tracy <eos>	notice ( winnifred , tracy ) <eos>	notice ( winnifred , tracy ) <eos>
oswald meets zelda <eos>	meet ( oswald , zelda ) <eos>	meet ( oswald , zelda ) <eos>
john knows lewis <eos>	know ( john , lewis ) <eos>	know ( john , lewis ) <eos>
lewis meets rachael <eos>	meet ( lewis , rachael ) <eos>	meet ( lewis , rachael ) <eos>
bob throws daniel <eos>	throw ( bob , daniel ) <eos>	throw ( bob , daniel ) <eos>
patricia likes oswald <eos>	like ( patricia , oswald ) <eos>	like ( patricia , oswald ) <eos>
john notices ursula <eos>	notice ( john , ursula ) <eos>	notice ( john , ursula ) <eos>
claire likes tracy <eos>	like ( claire , tracy ) <eos>	like ( claire , tracy ) <eos>
yvette throws john <eos>	throw ( yvettte , john ) <eos>	throw ( yvettte , john ) <eos>
quinn likes claire <eos>	like ( quinn , claire ) <eos>	like ( quinn , claire ) <eos>
bob throws winnifred <eos>	throw ( bob , winnifred ) <eos>	throw ( bob , winnifred ) <eos>
tracy likes claire <eos>	like ( tracy , claire ) <eos>	like ( tracy , claire ) <eos>
katherine meets herself <eos>	meet ( katherine , katherine ) <eos>	meet ( katherine , katherine ) <eos>
victor dislikes isla <eos>	dislike ( victor , isla ) <eos>	dislike ( victor , isla ) <eos>
eliza likes lewis <eos>	like ( eliza , lewis ) <eos>	like ( eliza , lewis ) <eos>
katherine notices bob <eos>	notice ( katherine , bob ) <eos>	notice ( katherine , bob ) <eos>
eliza dislikes rachael <eos>	dislike ( eliza , rachael ) <eos>	dislike ( eliza , rachael ) <eos>
francis sees katherine <eos>	see ( francis , katherine ) <eos>	see ( francis , katherine ) <eos>
isla likes isla <eos>	like ( isla , isla ) <eos>	like ( isla , isla ) <eos>
claire knows zelda <eos>	know ( claire , zelda ) <eos>	know ( claire , zelda ) <eos>
claire throws margaret <eos>	throw ( claire , margaret ) <eos>	throw ( claire , margaret ) <eos>
yvette notices oswald <eos>	notice ( yvettte , oswald ) <eos>	notice ( yvettte , oswald ) <eos>
victor eats <eos>	eat ( victor ) <eos>	eat ( victor ) <eos>
john sings <eos>	sing ( john ) <eos>	sing ( john ) <eos>
quinn flies <eos>	fly ( quinn ) <eos>	fly ( quinn ) <eos>
oswald eats <eos>	eat ( oswald ) <eos>	eat ( oswald ) <eos>
zelda dances <eos>	dance ( zelda ) <eos>	dance ( zelda ) <eos>
francis notices bob <eos>	notice ( francis , bob ) <eos>	notice ( francis , bob ) <eos>
victor meets john <eos>	meet ( victor , john ) <eos>	meet ( victor , john ) <eos>
patricia knows victor <eos>	know ( patricia , victor ) <eos>	know ( patricia , victor ) <eos>
margaret dislikes grace <eos>	dislike ( margaret , grace ) <eos>	dislike ( margaret , grace ) <eos>
eliza sees quinn <eos>	see ( eliza , quinn ) <eos>	see ( eliza , quinn ) <eos>
xerxes likes bob <eos>	like ( xerxes , bob ) <eos>	like ( xerxes , bob ) <eos>
rachael sees isla <eos>	see ( rachael , isla ) <eos>	see ( rachael , isla ) <eos>
katherine likes herself <eos>	like ( katherine , katherine ) <eos>	like ( katherine , katherine ) <eos>
francis likes himself <eos>	like ( francis , francis ) <eos>	like ( francis , francis ) <eos>
daniel meets victor <eos>	meet ( daniel , victor ) <eos>	meet ( daniel , victor ) <eos>
neha knows katherine <eos>	know ( neha , katherine ) <eos>	know ( neha , katherine ) <eos>
grace likes herself <eos>	like ( grace , grace ) <eos>	like ( grace , grace ) <eos>
xerxes dislikes himself <eos>	dislike ( xerxes , xerxes ) <eos>	dislike ( xerxes , xerxes ) <eos>
xerxes dislikes yvette <eos>	dislike ( xerxes , yvettte ) <eos>	dislike ( xerxes , yvettte ) <eos>
yvette sees grace <eos>	see ( yvettte , grace ) <eos>	see ( yvettte , grace ) <eos>
bob dislikes samuel <eos>	dislike ( bob , samuel ) <eos>	dislike ( bob , samuel ) <eos>
xerxes dislikes xerxes <eos>	dislike ( xerxes , xerxes ) <eos>	dislike ( xerxes , xerxes ) <eos>
daniel notices lewis <eos>	notice ( daniel , lewis ) <eos>	notice ( daniel , lewis ) <eos>
lewis likes patricia <eos>	like ( lewis , patricia ) <eos>	like ( lewis , patricia ) <eos>
yvette knows isla <eos>	know ( yvettte , isla ) <eos>	know ( yvettte , isla ) <eos>
margaret throws yvette <eos>	throw ( margaret , yvettte ) <eos>	throw ( margaret , yvettte ) <eos>
xerxes dislikes rachael <eos>	dislike ( xerxes , rachael ) <eos>	dislike ( xerxes , rachael ) <eos>
winnifred likes xerxes <eos>	like ( winnifred , xerxes ) <eos>	like ( winnifred , xerxes ) <eos>
tracy dislikes tracy <eos>	dislike ( tracy , tracy ) <eos>	dislike ( tracy , tracy ) <eos>
margaret notices francis <eos>	notice ( margaret , francis ) <eos>	notice ( margaret , francis ) <eos>
claire meets herself <eos>	meet ( claire , claire ) <eos>	meet ( claire , claire ) <eos>
margaret throws neha <eos>	throw ( margaret , neha ) <eos>	throw ( margaret , neha ) <eos>
alice throws winnifred <eos>	throw ( alice , winnifred ) <eos>	throw ( alice , winnifred ) <eos>
claire knows herself <eos>	know ( claire , claire ) <eos>	know ( claire , claire ) <eos>
margaret notices grace <eos>	notice ( margaret , grace ) <eos>	notice ( margaret , grace ) <eos>
isla knows neha <eos>	know ( isla , neha ) <eos>	know ( isla , neha ) <eos>
alice notices isla <eos>	notice ( alice , isla ) <eos>	notice ( alice , isla ) <eos>
winnifred meets xerxes <eos>	meet ( winnifred , xerxes ) <eos>	meet ( winnifred , xerxes ) <eos>
winnifred meets lewis <eos>	meet ( winnifred , lewis ) <eos>	meet ( winnifred , lewis ) <eos>
victor knows victor <eos>	know ( victor , victor ) <eos>	know ( victor , victor ) <eos>
henry knows oswald <eos>	know ( henry , oswald ) <eos>	know ( henry , oswald ) <eos>
katherine meets henry <eos>	meet ( katherine , henry ) <eos>	meet ( katherine , henry ) <eos>
katherine likes daniel <eos>	like ( katherine , daniel ) <eos>	like ( katherine , daniel ) <eos>
francis meets xerxes <eos>	meet ( francis , xerxes ) <eos>	meet ( francis , xerxes ) <eos>
alice meets isla <eos>	meet ( alice , isla ) <eos>	meet ( alice , isla ) <eos>
tracy throws isla <eos>	throw ( tracy , isla ) <eos>	throw ( tracy , isla ) <eos>
ursula throws xerxes <eos>	throw ( ursula , xerxes ) <eos>	throw ( ursula , xerxes ) <eos>
alice notices margaret <eos>	notice ( alice , margaret ) <eos>	notice ( alice , margaret ) <eos>
katherine meets katherine <eos>	meet ( katherine , katherine ) <eos>	meet ( katherine , katherine ) <eos>
rachael notices tracy <eos>	notice ( rachael , tracy ) <eos>	notice ( rachael , tracy ) <eos>
isla knows john <eos>	know ( isla , john ) <eos>	know ( isla , john ) <eos>
henry likes francis <eos>	like ( henry , francis ) <eos>	like ( henry , francis ) <eos>
xerxes notices quinn <eos>	notice ( xerxes , quinn ) <eos>	notice ( xerxes , quinn ) <eos>
eliza throws alice <eos>	throw ( eliza , alice ) <eos>	throw ( eliza , alice ) <eos>
yvette throws samuel <eos>	throw ( yvettte , samuel ) <eos>	throw ( yvettte , samuel ) <eos>
patricia meets tracy <eos>	meet ( patricia , tracy ) <eos>	meet ( patricia , tracy ) <eos>
alice dislikes victor <eos>	dislike ( alice , victor ) <eos>	dislike ( alice , victor ) <eos>
victor throws xerxes <eos>	throw ( victor , xerxes ) <eos>	throw ( victor , xerxes ) <eos>
tracy dislikes alice <eos>	dislike ( tracy , alice ) <eos>	dislike ( tracy , alice ) <eos>
oswald knows john <eos>	know ( oswald , john ) <eos>	know ( oswald , john ) <eos>
patricia sees winnifred <eos>	see ( patricia , winnifred ) <eos>	see ( patricia , winnifred ) <eos>
tracy meets claire <eos>	meet ( tracy , claire ) <eos>	meet ( tracy , claire ) <eos>
oswald sees claire <eos>	see ( oswald , claire ) <eos>	see ( oswald , claire ) <eos>
rachael likes john <eos>	like ( rachael , john ) <eos>	like ( rachael , john ) <eos>
yvette likes ursula <eos>	like ( yvettte , ursula ) <eos>	like ( yvettte , ursula ) <eos>
winnifred throws alice <eos>	throw ( winnifred , alice ) <eos>	throw ( winnifred , alice ) <eos>
tracy dislikes daniel <eos>	dislike ( tracy , daniel ) <eos>	dislike ( tracy , daniel ) <eos>
john meets alice <eos>	meet ( john , alice ) <eos>	meet ( john , alice ) <eos>
daniel knows alice <eos>	know ( daniel , alice ) <eos>	know ( daniel , alice ) <eos>
grace notices yvette <eos>	notice ( grace , yvettte ) <eos>	notice ( grace , yvettte ) <eos>
eliza notices margaret <eos>	notice ( eliza , margaret ) <eos>	notice ( eliza , margaret ) <eos>
patricia likes victor <eos>	like ( patricia , victor ) <eos>	like ( patricia , victor ) <eos>
grace likes grace <eos>	like ( grace , grace ) <eos>	like ( grace , grace ) <eos>
john sees claire <eos>	see ( john , claire ) <eos>	see ( john , claire ) <eos>
oswald meets claire <eos>	meet ( oswald , claire ) <eos>	meet ( oswald , claire ) <eos>
quinn slumbers <eos>	slumber ( quinn ) <eos>	slumber ( quinn ) <eos>
isla slumbers <eos>	slumber ( isla ) <eos>	slumber ( isla ) <eos>
bob flies <eos>	fly ( bob ) <eos>	fly ( bob ) <eos>
yvette walks <eos>	walk ( yvettte ) <eos>	walk ( yvettte ) <eos>
henry dances <eos>	dance ( henry ) <eos>	dance ( henry ) <eos>
yvette knows patricia <eos>	know ( yvettte , patricia ) <eos>	know ( yvettte , patricia ) <eos>
katherine meets margaret <eos>	meet ( katherine , margaret ) <eos>	meet ( katherine , margaret ) <eos>
neha throws samuel <eos>	throw ( neha , samuel ) <eos>	throw ( neha , samuel ) <eos>
katherine throws eliza <eos>	throw ( katherine , eliza ) <eos>	throw ( katherine , eliza ) <eos>
ursula dislikes margaret <eos>	dislike ( ursula , margaret ) <eos>	dislike ( ursula , margaret ) <eos>
rachael sees xerxes <eos>	see ( rachael , xerxes ) <eos>	see ( rachael , xerxes ) <eos>
daniel throws neha <eos>	throw ( daniel , neha ) <eos>	throw ( daniel , neha ) <eos>
neha meets john <eos>	meet ( neha , john ) <eos>	meet ( neha , john ) <eos>
eliza notices katherine <eos>	notice ( eliza , katherine ) <eos>	notice ( eliza , katherine ) <eos>
eliza knows eliza <eos>	know ( eliza , eliza ) <eos>	know ( eliza , eliza ) <eos>
eliza throws henry <eos>	throw ( eliza , henry ) <eos>	throw ( eliza , henry ) <eos>
eliza knows isla <eos>	know ( eliza , isla ) <eos>	know ( eliza , isla ) <eos>
claire meets eliza <eos>	meet ( claire , eliza ) <eos>	meet ( claire , eliza ) <eos>
isla knows herself <eos>	know ( isla , isla ) <eos>	know ( isla , victor ) <eos>
claire notices oswald <eos>	notice ( claire , oswald ) <eos>	notice ( claire , oswald ) <eos>
daniel throws henry <eos>	throw ( daniel , henry ) <eos>	throw ( daniel , henry ) <eos>
margaret throws quinn <eos>	throw ( margaret , quinn ) <eos>	throw ( margaret , quinn ) <eos>
winnifred likes grace <eos>	like ( winnifred , grace ) <eos>	like ( winnifred , grace ) <eos>
henry meets henry <eos>	meet ( henry , henry ) <eos>	meet ( henry , henry ) <eos>
daniel notices alice <eos>	notice ( daniel , alice ) <eos>	notice ( daniel , alice ) <eos>
victor throws victor <eos>	throw ( victor , victor ) <eos>	throw ( victor , victor ) <eos>
grace knows grace <eos>	know ( grace , grace ) <eos>	know ( grace , grace ) <eos>
eliza dislikes lewis <eos>	dislike ( eliza , lewis ) <eos>	dislike ( eliza , lewis ) <eos>
winnifred throws zelda <eos>	throw ( winnifred , zelda ) <eos>	throw ( winnifred , zelda ) <eos>
winnifred meets rachael <eos>	meet ( winnifred , rachael ) <eos>	meet ( winnifred , rachael ) <eos>
claire dislikes herself <eos>	dislike ( claire , claire ) <eos>	dislike ( claire , claire ) <eos>
daniel notices rachael <eos>	notice ( daniel , rachael ) <eos>	notice ( daniel , rachael ) <eos>
henry meets victor <eos>	meet ( henry , victor ) <eos>	meet ( henry , victor ) <eos>
samuel knows winnifred <eos>	know ( samuel , winnifred ) <eos>	know ( samuel , winnifred ) <eos>
yvette throws alice <eos>	throw ( yvettte , alice ) <eos>	throw ( yvettte , alice ) <eos>
katherine throws alice <eos>	throw ( katherine , alice ) <eos>	throw ( katherine , alice ) <eos>
francis meets winnifred <eos>	meet ( francis , winnifred ) <eos>	meet ( francis , winnifred ) <eos>
zelda sees herself <eos>	see ( zelda , zelda ) <eos>	see ( zelda , zelda ) <eos>
zelda likes john <eos>	like ( zelda , john ) <eos>	like ( zelda , john ) <eos>
victor meets tracy <eos>	meet ( victor , tracy ) <eos>	meet ( victor , tracy ) <eos>
grace likes oswald <eos>	like ( grace , oswald ) <eos>	like ( grace , oswald ) <eos>
margaret sees francis <eos>	see ( margaret , francis ) <eos>	see ( margaret , francis ) <eos>
alice notices xerxes <eos>	notice ( alice , xerxes ) <eos>	notice ( alice , xerxes ) <eos>
margaret sees ursula <eos>	see ( margaret , ursula ) <eos>	see ( margaret , ursula ) <eos>
isla meets isla <eos>	meet ( isla , isla ) <eos>	meet ( isla , isla ) <eos>
katherine meets claire <eos>	meet ( katherine , claire ) <eos>	meet ( katherine , claire ) <eos>
isla throws isla <eos>	throw ( isla , isla ) <eos>	throw ( isla , isla ) <eos>
henry notices alice <eos>	notice ( henry , alice ) <eos>	notice ( henry , alice ) <eos>
lewis knows claire <eos>	know ( lewis , claire ) <eos>	know ( lewis , claire ) <eos>
tracy likes rachael <eos>	like ( tracy , rachael ) <eos>	like ( tracy , rachael ) <eos>
lewis dislikes neha <eos>	dislike ( lewis , neha ) <eos>	dislike ( lewis , neha ) <eos>
neha sees neha <eos>	see ( neha , neha ) <eos>	see ( neha , neha ) <eos>
francis knows claire <eos>	know ( francis , claire ) <eos>	know ( francis , claire ) <eos>
katherine likes patricia <eos>	like ( katherine , patricia ) <eos>	like ( katherine , patricia ) <eos>
claire throws herself <eos>	throw ( claire , claire ) <eos>	throw ( claire , claire ) <eos>
alice dislikes herself <eos>	dislike ( alice , alice ) <eos>	dislike ( alice , claire ) <eos>
victor sees winnifred <eos>	see ( victor , winnifred ) <eos>	see ( victor , winnifred ) <eos>
katherine notices patricia <eos>	notice ( katherine , patricia ) <eos>	notice ( katherine , patricia ) <eos>
tracy sees ursula <eos>	see ( tracy , ursula ) <eos>	see ( tracy , ursula ) <eos>
daniel notices daniel <eos>	notice ( daniel , daniel ) <eos>	notice ( daniel , daniel ) <eos>
claire notices quinn <eos>	notice ( claire , quinn ) <eos>	notice ( claire , quinn ) <eos>
xerxes knows francis <eos>	know ( xerxes , francis ) <eos>	know ( xerxes , francis ) <eos>
bob knows john <eos>	know ( bob , john ) <eos>	know ( bob , john ) <eos>
ursula knows eliza <eos>	know ( ursula , eliza ) <eos>	know ( ursula , eliza ) <eos>
isla dislikes isla <eos>	dislike ( isla , isla ) <eos>	dislike ( isla , isla ) <eos>
winnifred notices henry <eos>	notice ( winnifred , henry ) <eos>	notice ( winnifred , henry ) <eos>
isla sees francis <eos>	see ( isla , francis ) <eos>	see ( isla , francis ) <eos>
bob notices lewis <eos>	notice ( bob , lewis ) <eos>	notice ( bob , lewis ) <eos>
henry sees isla <eos>	see ( henry , isla ) <eos>	see ( henry , isla ) <eos>
grace sees herself <eos>	see ( grace , grace ) <eos>	see ( grace , grace ) <eos>
alice likes francis <eos>	like ( alice , francis ) <eos>	like ( alice , francis ) <eos>
margaret throws rachael <eos>	throw ( margaret , rachael ) <eos>	throw ( margaret , rachael ) <eos>
grace knows margaret <eos>	know ( grace , margaret ) <eos>	know ( grace , margaret ) <eos>
oswald dislikes alice <eos>	dislike ( oswald , alice ) <eos>	dislike ( oswald , alice ) <eos>
eliza likes grace <eos>	like ( eliza , grace ) <eos>	like ( eliza , grace ) <eos>
yvette dislikes tracy <eos>	dislike ( yvettte , tracy ) <eos>	dislike ( yvettte , tracy ) <eos>
samuel knows patricia <eos>	know ( samuel , patricia ) <eos>	know ( samuel , patricia ) <eos>
grace sees patricia <eos>	see ( grace , patricia ) <eos>	see ( grace , patricia ) <eos>
patricia likes bob <eos>	like ( patricia , bob ) <eos>	like ( patricia , bob ) <eos>
claire knows winnifred <eos>	know ( claire , winnifred ) <eos>	know ( claire , winnifred ) <eos>
yvette meets victor <eos>	meet ( yvettte , victor ) <eos>	meet ( yvettte , victor ) <eos>
patricia notices lewis <eos>	notice ( patricia , lewis ) <eos>	notice ( patricia , lewis ) <eos>
victor throws margaret <eos>	throw ( victor , margaret ) <eos>	throw ( victor , margaret ) <eos>
grace notices grace <eos>	notice ( grace , grace ) <eos>	notice ( grace , grace ) <eos>
quinn likes yvette <eos>	like ( quinn , yvettte ) <eos>	like ( quinn , yvettte ) <eos>
claire meets claire <eos>	meet ( claire , claire ) <eos>	meet ( claire , claire ) <eos>
yvette likes isla <eos>	like ( yvettte , isla ) <eos>	like ( yvettte , isla ) <eos>
claire knows claire <eos>	know ( claire , claire ) <eos>	know ( claire , claire ) <eos>
oswald likes winnifred <eos>	like ( oswald , winnifred ) <eos>	like ( oswald , winnifred ) <eos>
rachael meets neha <eos>	meet ( rachael , neha ) <eos>	meet ( rachael , neha ) <eos>
grace throws herself <eos>	throw ( grace , grace ) <eos>	throw ( grace , grace ) <eos>
quinn dislikes francis <eos>	dislike ( quinn , francis ) <eos>	dislike ( quinn , francis ) <eos>
ursula dislikes alice <eos>	dislike ( ursula , alice ) <eos>	dislike ( ursula , alice ) <eos>
katherine dislikes herself <eos>	dislike ( katherine , katherine ) <eos>	dislike ( katherine , katherine ) <eos>
neha meets henry <eos>	meet ( neha , henry ) <eos>	meet ( neha , henry ) <eos>
neha notices oswald <eos>	notice ( neha , oswald ) <eos>	notice ( neha , oswald ) <eos>
neha sees zelda <eos>	see ( neha , zelda ) <eos>	see ( neha , zelda ) <eos>
isla dislikes alice <eos>	dislike ( isla , alice ) <eos>	dislike ( isla , alice ) <eos>
eliza dislikes samuel <eos>	dislike ( eliza , samuel ) <eos>	dislike ( eliza , samuel ) <eos>
daniel likes samuel <eos>	like ( daniel , samuel ) <eos>	like ( daniel , samuel ) <eos>
francis knows samuel <eos>	know ( francis , samuel ) <eos>	know ( francis , samuel ) <eos>
bob notices alice <eos>	notice ( bob , alice ) <eos>	notice ( bob , alice ) <eos>
lewis likes ursula <eos>	like ( lewis , ursula ) <eos>	like ( lewis , ursula ) <eos>
bob notices henry <eos>	notice ( bob , henry ) <eos>	notice ( bob , henry ) <eos>
zelda notices herself <eos>	notice ( zelda , zelda ) <eos>	notice ( zelda , zelda ) <eos>
grace dislikes quinn <eos>	dislike ( grace , quinn ) <eos>	dislike ( grace , quinn ) <eos>
claire throws neha <eos>	throw ( claire , neha ) <eos>	throw ( claire , neha ) <eos>
oswald dislikes samuel <eos>	dislike ( oswald , samuel ) <eos>	dislike ( oswald , samuel ) <eos>
lewis meets oswald <eos>	meet ( lewis , oswald ) <eos>	meet ( lewis , oswald ) <eos>
claire notices winnifred <eos>	notice ( claire , winnifred ) <eos>	notice ( claire , winnifred ) <eos>
francis throws john <eos>	throw ( francis , john ) <eos>	throw ( francis , john ) <eos>
isla sees neha <eos>	see ( isla , neha ) <eos>	see ( isla , neha ) <eos>
victor likes rachael <eos>	like ( victor , rachael ) <eos>	like ( victor , rachael ) <eos>
quinn dislikes victor <eos>	dislike ( quinn , victor ) <eos>	dislike ( quinn , victor ) <eos>
ursula knows katherine <eos>	know ( ursula , katherine ) <eos>	know ( ursula , katherine ) <eos>
neha meets daniel <eos>	meet ( neha , daniel ) <eos>	meet ( neha , daniel ) <eos>
tracy likes victor <eos>	like ( tracy , victor ) <eos>	like ( tracy , victor ) <eos>
tracy meets neha <eos>	meet ( tracy , neha ) <eos>	meet ( tracy , neha ) <eos>
yvette throws zelda <eos>	throw ( yvettte , zelda ) <eos>	throw ( yvettte , zelda ) <eos>
isla sees isla <eos>	see ( isla , isla ) <eos>	see ( isla , isla ) <eos>
winnifred knows neha <eos>	know ( winnifred , neha ) <eos>	know ( winnifred , neha ) <eos>
samuel dislikes francis <eos>	dislike ( samuel , francis ) <eos>	dislike ( samuel , francis ) <eos>
quinn notices francis <eos>	notice ( quinn , francis ) <eos>	notice ( quinn , francis ) <eos>
samuel knows xerxes <eos>	know ( samuel , xerxes ) <eos>	know ( samuel , xerxes ) <eos>
ursula meets quinn <eos>	meet ( ursula , quinn ) <eos>	meet ( ursula , quinn ) <eos>
tracy sees samuel <eos>	see ( tracy , samuel ) <eos>	see ( tracy , samuel ) <eos>
alice throws alice <eos>	throw ( alice , alice ) <eos>	throw ( alice , alice ) <eos>
bob likes bob <eos>	like ( bob , bob ) <eos>	like ( bob , bob ) <eos>
margaret notices zelda <eos>	notice ( margaret , zelda ) <eos>	notice ( margaret , zelda ) <eos>
zelda dislikes victor <eos>	dislike ( zelda , victor ) <eos>	dislike ( zelda , victor ) <eos>
ursula knows quinn <eos>	know ( ursula , quinn ) <eos>	know ( ursula , quinn ) <eos>
grace sees grace <eos>	see ( grace , grace ) <eos>	see ( grace , grace ) <eos>
henry throws rachael <eos>	throw ( henry , rachael ) <eos>	throw ( henry , rachael ) <eos>
zelda throws neha <eos>	throw ( zelda , neha ) <eos>	throw ( zelda , neha ) <eos>
oswald notices yvette <eos>	notice ( oswald , yvettte ) <eos>	notice ( oswald , yvettte ) <eos>
ursula meets margaret <eos>	meet ( ursula , margaret ) <eos>	meet ( ursula , margaret ) <eos>
oswald throws lewis <eos>	throw ( oswald , lewis ) <eos>	throw ( oswald , lewis ) <eos>
patricia throws samuel <eos>	throw ( patricia , samuel ) <eos>	throw ( patricia , samuel ) <eos>
francis notices lewis <eos>	notice ( francis , lewis ) <eos>	notice ( francis , lewis ) <eos>
claire dislikes john <eos>	dislike ( claire , john ) <eos>	dislike ( claire , john ) <eos>
alice eats <eos>	eat ( alice ) <eos>	eat ( alice ) <eos>
alice slumbers <eos>	slumber ( alice ) <eos>	slumber ( alice ) <eos>
patricia slumbers <eos>	slumber ( patricia ) <eos>	slumber ( patricia ) <eos>
lewis eats <eos>	eat ( lewis ) <eos>	eat ( lewis ) <eos>
ursula slumbers <eos>	slumber ( ursula ) <eos>	slumber ( ursula ) <eos>
eliza meets isla <eos>	meet ( eliza , isla ) <eos>	meet ( eliza , isla ) <eos>
tracy dislikes isla <eos>	dislike ( tracy , isla ) <eos>	dislike ( tracy , isla ) <eos>
john sees victor <eos>	see ( john , victor ) <eos>	see ( john , victor ) <eos>
patricia sees isla <eos>	see ( patricia , isla ) <eos>	see ( patricia , isla ) <eos>
quinn throws bob <eos>	throw ( quinn , bob ) <eos>	throw ( quinn , bob ) <eos>
quinn dislikes claire <eos>	dislike ( quinn , claire ) <eos>	dislike ( quinn , claire ) <eos>
bob notices grace <eos>	notice ( bob , grace ) <eos>	notice ( bob , grace ) <eos>
alice sees herself <eos>	see ( alice , alice ) <eos>	see ( alice , winnifred ) <eos>
claire notices claire <eos>	notice ( claire , claire ) <eos>	notice ( claire , claire ) <eos>
bob throws himself <eos>	throw ( bob , bob ) <eos>	throw ( bob , bob ) <eos>
john meets samuel <eos>	meet ( john , samuel ) <eos>	meet ( john , samuel ) <eos>
katherine sees winnifred <eos>	see ( katherine , winnifred ) <eos>	see ( katherine , winnifred ) <eos>
winnifred sees patricia <eos>	see ( winnifred , patricia ) <eos>	see ( winnifred , patricia ) <eos>
victor knows daniel <eos>	know ( victor , daniel ) <eos>	know ( victor , daniel ) <eos>
alice meets herself <eos>	meet ( alice , alice ) <eos>	meet ( alice , alice ) <eos>
francis likes daniel <eos>	like ( francis , daniel ) <eos>	like ( francis , daniel ) <eos>
alice likes herself <eos>	like ( alice , alice ) <eos>	like ( alice , claire ) <eos>
francis knows patricia <eos>	know ( francis , patricia ) <eos>	know ( francis , patricia ) <eos>
lewis meets tracy <eos>	meet ( lewis , tracy ) <eos>	meet ( lewis , tracy ) <eos>
lewis likes bob <eos>	like ( lewis , bob ) <eos>	like ( lewis , bob ) <eos>
henry sees henry <eos>	see ( henry , henry ) <eos>	see ( henry , henry ) <eos>
neha throws zelda <eos>	throw ( neha , zelda ) <eos>	throw ( neha , zelda ) <eos>
claire likes claire <eos>	like ( claire , claire ) <eos>	like ( claire , claire ) <eos>
bob dislikes quinn <eos>	dislike ( bob , quinn ) <eos>	dislike ( bob , quinn ) <eos>
lewis likes eliza <eos>	like ( lewis , eliza ) <eos>	like ( lewis , eliza ) <eos>
yvette sees lewis <eos>	see ( yvettte , lewis ) <eos>	see ( yvettte , lewis ) <eos>
john dislikes himself <eos>	dislike ( john , john ) <eos>	dislike ( john , john ) <eos>
grace notices herself <eos>	notice ( grace , grace ) <eos>	notice ( grace , grace ) <eos>
daniel knows tracy <eos>	know ( daniel , tracy ) <eos>	know ( daniel , tracy ) <eos>
margaret dislikes xerxes <eos>	dislike ( margaret , xerxes ) <eos>	dislike ( margaret , xerxes ) <eos>
grace notices claire <eos>	notice ( grace , claire ) <eos>	notice ( grace , claire ) <eos>
lewis sees rachael <eos>	see ( lewis , rachael ) <eos>	see ( lewis , rachael ) <eos>
alice meets daniel <eos>	meet ( alice , daniel ) <eos>	meet ( alice , daniel ) <eos>
patricia meets isla <eos>	meet ( patricia , isla ) <eos>	meet ( patricia , isla ) <eos>
oswald sees xerxes <eos>	see ( oswald , xerxes ) <eos>	see ( oswald , xerxes ) <eos>
daniel sings <eos>	sing ( daniel ) <eos>	sing ( daniel ) <eos>
katherine sings <eos>	sing ( katherine ) <eos>	sing ( katherine ) <eos>
claire slumbers <eos>	slumber ( claire ) <eos>	slumber ( claire ) <eos>
isla sleeps <eos>	sleep ( isla ) <eos>	sleep ( isla ) <eos>
patricia sings <eos>	sing ( patricia ) <eos>	sing ( patricia ) <eos>
oswald sees daniel <eos>	see ( oswald , daniel ) <eos>	see ( oswald , daniel ) <eos>
lewis throws margaret <eos>	throw ( lewis , margaret ) <eos>	throw ( lewis , margaret ) <eos>
daniel throws claire <eos>	throw ( daniel , claire ) <eos>	throw ( daniel , claire ) <eos>
winnifred meets patricia <eos>	meet ( winnifred , patricia ) <eos>	meet ( winnifred , patricia ) <eos>
katherine throws rachael <eos>	throw ( katherine , rachael ) <eos>	throw ( katherine , rachael ) <eos>
samuel sees lewis <eos>	see ( samuel , lewis ) <eos>	see ( samuel , lewis ) <eos>
eliza meets eliza <eos>	meet ( eliza , eliza ) <eos>	meet ( eliza , eliza ) <eos>
margaret knows margaret <eos>	know ( margaret , margaret ) <eos>	know ( margaret , margaret ) <eos>
margaret knows katherine <eos>	know ( margaret , katherine ) <eos>	know ( margaret , katherine ) <eos>
quinn likes oswald <eos>	like ( quinn , oswald ) <eos>	like ( quinn , oswald ) <eos>
bob likes alice <eos>	like ( bob , alice ) <eos>	like ( bob , alice ) <eos>
zelda throws samuel <eos>	throw ( zelda , samuel ) <eos>	throw ( zelda , samuel ) <eos>
bob sees himself <eos>	see ( bob , bob ) <eos>	see ( bob , bob ) <eos>
tracy sees john <eos>	see ( tracy , john ) <eos>	see ( tracy , john ) <eos>
daniel notices xerxes <eos>	notice ( daniel , xerxes ) <eos>	notice ( daniel , xerxes ) <eos>
oswald sees patricia <eos>	see ( oswald , patricia ) <eos>	see ( oswald , patricia ) <eos>
oswald sees isla <eos>	see ( oswald , isla ) <eos>	see ( oswald , isla ) <eos>
alice likes alice <eos>	like ( alice , alice ) <eos>	like ( alice , alice ) <eos>
yvette throws lewis <eos>	throw ( yvettte , lewis ) <eos>	throw ( yvettte , lewis ) <eos>
grace meets samuel <eos>	meet ( grace , samuel ) <eos>	meet ( grace , samuel ) <eos>
eliza throws bob <eos>	throw ( eliza , bob ) <eos>	throw ( eliza , bob ) <eos>
tracy sees lewis <eos>	see ( tracy , lewis ) <eos>	see ( tracy , lewis ) <eos>
ursula likes rachael <eos>	like ( ursula , rachael ) <eos>	like ( ursula , rachael ) <eos>
tracy meets xerxes <eos>	meet ( tracy , xerxes ) <eos>	meet ( tracy , xerxes ) <eos>
grace throws grace <eos>	throw ( grace , grace ) <eos>	throw ( grace , grace ) <eos>
neha sees yvette <eos>	see ( neha , yvettte ) <eos>	see ( neha , yvettte ) <eos>
katherine throws ursula <eos>	throw ( katherine , ursula ) <eos>	throw ( katherine , ursula ) <eos>
grace throws yvette <eos>	throw ( grace , yvettte ) <eos>	throw ( grace , yvettte ) <eos>
margaret meets victor <eos>	meet ( margaret , victor ) <eos>	meet ( margaret , victor ) <eos>
katherine meets alice <eos>	meet ( katherine , alice ) <eos>	meet ( katherine , alice ) <eos>
rachael knows winnifred <eos>	know ( rachael , winnifred ) <eos>	know ( rachael , winnifred ) <eos>
margaret knows john <eos>	know ( margaret , john ) <eos>	know ( margaret , john ) <eos>
claire throws patricia <eos>	throw ( claire , patricia ) <eos>	throw ( claire , patricia ) <eos>
isla knows zelda <eos>	know ( isla , zelda ) <eos>	know ( isla , zelda ) <eos>
rachael likes ursula <eos>	like ( rachael , ursula ) <eos>	like ( rachael , ursula ) <eos>
alice dislikes eliza <eos>	dislike ( alice , eliza ) <eos>	dislike ( alice , eliza ) <eos>
grace sees eliza <eos>	see ( grace , eliza ) <eos>	see ( grace , eliza ) <eos>
francis meets grace <eos>	meet ( francis , grace ) <eos>	meet ( francis , grace ) <eos>
daniel throws isla <eos>	throw ( daniel , isla ) <eos>	throw ( daniel , isla ) <eos>
winnifred sees francis <eos>	see ( winnifred , francis ) <eos>	see ( winnifred , francis ) <eos>
margaret likes lewis <eos>	like ( margaret , lewis ) <eos>	like ( margaret , lewis ) <eos>
zelda sees daniel <eos>	see ( zelda , daniel ) <eos>	see ( zelda , daniel ) <eos>
alice likes isla <eos>	like ( alice , isla ) <eos>	like ( alice , isla ) <eos>
winnifred dislikes zelda <eos>	dislike ( winnifred , zelda ) <eos>	dislike ( winnifred , zelda ) <eos>
john throws eliza <eos>	throw ( john , eliza ) <eos>	throw ( john , eliza ) <eos>
quinn knows margaret <eos>	know ( quinn , margaret ) <eos>	know ( quinn , margaret ) <eos>
isla sees quinn <eos>	see ( isla , quinn ) <eos>	see ( isla , quinn ) <eos>
oswald meets rachael <eos>	meet ( oswald , rachael ) <eos>	meet ( oswald , rachael ) <eos>
daniel notices grace <eos>	notice ( daniel , grace ) <eos>	notice ( daniel , grace ) <eos>
margaret likes winnifred <eos>	like ( margaret , winnifred ) <eos>	like ( margaret , winnifred ) <eos>
oswald knows rachael <eos>	know ( oswald , rachael ) <eos>	know ( oswald , rachael ) <eos>
grace meets grace <eos>	meet ( grace , grace ) <eos>	meet ( grace , grace ) <eos>
isla dislikes henry <eos>	dislike ( isla , henry ) <eos>	dislike ( isla , henry ) <eos>
xerxes notices tracy <eos>	notice ( xerxes , tracy ) <eos>	notice ( xerxes , tracy ) <eos>
daniel knows xerxes <eos>	know ( daniel , xerxes ) <eos>	know ( daniel , xerxes ) <eos>
eliza likes claire <eos>	like ( eliza , claire ) <eos>	like ( eliza , claire ) <eos>
quinn likes ursula <eos>	like ( quinn , ursula ) <eos>	like ( quinn , ursula ) <eos>
alice notices bob <eos>	notice ( alice , bob ) <eos>	notice ( alice , bob ) <eos>
daniel sees daniel <eos>	see ( daniel , daniel ) <eos>	see ( daniel , daniel ) <eos>
grace meets henry <eos>	meet ( grace , henry ) <eos>	meet ( grace , henry ) <eos>
claire dislikes claire <eos>	dislike ( claire , claire ) <eos>	dislike ( claire , claire ) <eos>
xerxes sees oswald <eos>	see ( xerxes , oswald ) <eos>	see ( xerxes , oswald ) <eos>
daniel sees bob <eos>	see ( daniel , bob ) <eos>	see ( daniel , bob ) <eos>
eliza likes john <eos>	like ( eliza , john ) <eos>	like ( eliza , john ) <eos>
quinn dislikes zelda <eos>	dislike ( quinn , zelda ) <eos>	dislike ( quinn , zelda ) <eos>
margaret likes katherine <eos>	like ( margaret , katherine ) <eos>	like ( margaret , katherine ) <eos>
katherine meets francis <eos>	meet ( katherine , francis ) <eos>	meet ( katherine , francis ) <eos>
rachael meets samuel <eos>	meet ( rachael , samuel ) <eos>	meet ( rachael , samuel ) <eos>
grace likes henry <eos>	like ( grace , henry ) <eos>	like ( grace , henry ) <eos>
alice sees alice <eos>	see ( alice , alice ) <eos>	see ( alice , alice ) <eos>
alice likes samuel <eos>	like ( alice , samuel ) <eos>	like ( alice , samuel ) <eos>
neha meets lewis <eos>	meet ( neha , lewis ) <eos>	meet ( neha , lewis ) <eos>
yvette likes samuel <eos>	like ( yvettte , samuel ) <eos>	like ( yvettte , samuel ) <eos>
oswald dislikes victor <eos>	dislike ( oswald , victor ) <eos>	dislike ( oswald , victor ) <eos>
ursula knows winnifred <eos>	know ( ursula , winnifred ) <eos>	know ( ursula , winnifred ) <eos>
oswald likes john <eos>	like ( oswald , john ) <eos>	like ( oswald , john ) <eos>
